"";"Regija";"Placilni.razred";"Leto";"Skupaj.spol";"Moski";"Zenske"
"1";"SLOVENIJA";"Razred neto - SKUPAJ";"2009";596574;331231;265343
"2";"SLOVENIJA";"Razred neto - SKUPAJ";"2010";570099;313340;256759
"3";"SLOVENIJA";"Razred neto - SKUPAJ";"2011";551574;297144;254430
"4";"SLOVENIJA";"Razred neto - SKUPAJ";"2012";537938;289691;248247
"5";"SLOVENIJA";"Razred neto - SKUPAJ";"2013";532682;285087;247595
"6";"SLOVENIJA";"Razred neto - SKUPAJ";"2014";540094;292276;247818
"7";"SLOVENIJA";"Razred neto - SKUPAJ";"2015";534514;290046;244468
"8";"SLOVENIJA";"Razred neto - SKUPAJ";"2016";541427;291873;249554
"9";"SLOVENIJA";"Razred neto - SKUPAJ";"2017 (začasni podatki)";562154;304195;257959
"10";"SLOVENIJA";"01";"2009";29563;17457;12106
"11";"SLOVENIJA";"01";"2010";28240;14772;13468
"12";"SLOVENIJA";"01";"2011";26382;12668;13714
"13";"SLOVENIJA";"01";"2012";26585;12870;13715
"14";"SLOVENIJA";"01";"2013";26188;12285;13903
"15";"SLOVENIJA";"01";"2014";26382;12496;13886
"16";"SLOVENIJA";"01";"2015";27360;12786;14574
"17";"SLOVENIJA";"01";"2016";26557;12641;13916
"18";"SLOVENIJA";"01";"2017 (začasni podatki)";27950;13636;14314
"19";"SLOVENIJA";"02";"2009";29687;14822;14865
"20";"SLOVENIJA";"02";"2010";27947;14101;13846
"21";"SLOVENIJA";"02";"2011";28644;13145;15499
"22";"SLOVENIJA";"02";"2012";25761;11440;14321
"23";"SLOVENIJA";"02";"2013";26793;11334;15459
"24";"SLOVENIJA";"02";"2014";24965;10667;14298
"25";"SLOVENIJA";"02";"2015";26234;11490;14744
"26";"SLOVENIJA";"02";"2016";26497;11477;15020
"27";"SLOVENIJA";"02";"2017 (začasni podatki)";28221;12687;15534
"28";"SLOVENIJA";"03";"2009";29997;13707;16290
"29";"SLOVENIJA";"03";"2010";28694;13656;15038
"30";"SLOVENIJA";"03";"2011";27353;13386;13967
"31";"SLOVENIJA";"03";"2012";28182;13414;14768
"32";"SLOVENIJA";"03";"2013";26581;13196;13385
"33";"SLOVENIJA";"03";"2014";29505;14485;15020
"34";"SLOVENIJA";"03";"2015";26935;13218;13717
"35";"SLOVENIJA";"03";"2016";28084;13268;14816
"36";"SLOVENIJA";"03";"2017 (začasni podatki)";27677;12930;14747
"37";"SLOVENIJA";"04";"2009";30012;14010;16002
"38";"SLOVENIJA";"04";"2010";28538;13906;14632
"39";"SLOVENIJA";"04";"2011";27700;13394;14306
"40";"SLOVENIJA";"04";"2012";26679;12973;13706
"41";"SLOVENIJA";"04";"2013";26182;12240;13942
"42";"SLOVENIJA";"04";"2014";26708;12602;14106
"43";"SLOVENIJA";"04";"2015";27071;12749;14322
"44";"SLOVENIJA";"04";"2016";26903;12502;14401
"45";"SLOVENIJA";"04";"2017 (začasni podatki)";27960;12814;15146
"46";"SLOVENIJA";"05";"2009";29430;15477;13953
"47";"SLOVENIJA";"05";"2010";28405;14561;13844
"48";"SLOVENIJA";"05";"2011";27207;13818;13389
"49";"SLOVENIJA";"05";"2012";26729;13033;13696
"50";"SLOVENIJA";"05";"2013";27101;13327;13774
"51";"SLOVENIJA";"05";"2014";27328;13724;13604
"52";"SLOVENIJA";"05";"2015";26598;13376;13222
"53";"SLOVENIJA";"05";"2016";26716;13350;13366
"54";"SLOVENIJA";"05";"2017 (začasni podatki)";28342;13942;14400
"55";"SLOVENIJA";"06";"2009";29677;16959;12718
"56";"SLOVENIJA";"06";"2010";29140;15881;13259
"57";"SLOVENIJA";"06";"2011";27599;14477;13122
"58";"SLOVENIJA";"06";"2012";26874;14285;12589
"59";"SLOVENIJA";"06";"2013";26741;14395;12346
"60";"SLOVENIJA";"06";"2014";27120;14799;12321
"61";"SLOVENIJA";"06";"2015";26413;14345;12068
"62";"SLOVENIJA";"06";"2016";27248;14746;12502
"63";"SLOVENIJA";"06";"2017 (začasni podatki)";28493;15204;13289
"64";"SLOVENIJA";"07";"2009";29879;17813;12066
"65";"SLOVENIJA";"07";"2010";28424;16552;11872
"66";"SLOVENIJA";"07";"2011";27682;15982;11700
"67";"SLOVENIJA";"07";"2012";27453;15861;11592
"68";"SLOVENIJA";"07";"2013";26739;15214;11525
"69";"SLOVENIJA";"07";"2014";26786;15537;11249
"70";"SLOVENIJA";"07";"2015";26564;15265;11299
"71";"SLOVENIJA";"07";"2016";27200;15749;11451
"72";"SLOVENIJA";"07";"2017 (začasni podatki)";27585;15959;11626
"73";"SLOVENIJA";"08";"2009";30186;18772;11414
"74";"SLOVENIJA";"08";"2010";28503;17479;11024
"75";"SLOVENIJA";"08";"2011";28051;16848;11203
"76";"SLOVENIJA";"08";"2012";26860;16194;10666
"77";"SLOVENIJA";"08";"2013";26342;15840;10502
"78";"SLOVENIJA";"08";"2014";26908;16166;10742
"79";"SLOVENIJA";"08";"2015";27103;16467;10636
"80";"SLOVENIJA";"08";"2016";27110;16324;10786
"81";"SLOVENIJA";"08";"2017 (začasni podatki)";28234;16985;11249
"82";"SLOVENIJA";"09";"2009";29995;19089;10906
"83";"SLOVENIJA";"09";"2010";28122;17520;10602
"84";"SLOVENIJA";"09";"2011";27389;16843;10546
"85";"SLOVENIJA";"09";"2012";26631;16307;10324
"86";"SLOVENIJA";"09";"2013";26804;16341;10463
"87";"SLOVENIJA";"09";"2014";27199;16495;10704
"88";"SLOVENIJA";"09";"2015";26334;15760;10574
"89";"SLOVENIJA";"09";"2016";27055;16286;10769
"90";"SLOVENIJA";"09";"2017 (začasni podatki)";28064;16942;11122
"91";"SLOVENIJA";"10";"2009";29405;18634;10771
"92";"SLOVENIJA";"10";"2010";28929;17758;11171
"93";"SLOVENIJA";"10";"2011";27754;16721;11033
"94";"SLOVENIJA";"10";"2012";26954;16192;10762
"95";"SLOVENIJA";"10";"2013";26631;15808;10823
"96";"SLOVENIJA";"10";"2014";27006;16112;10894
"97";"SLOVENIJA";"10";"2015";26721;15851;10870
"98";"SLOVENIJA";"10";"2016";27017;15995;11022
"99";"SLOVENIJA";"10";"2017 (začasni podatki)";28199;16513;11686
"100";"SLOVENIJA";"11";"2009";30121;18319;11802
"101";"SLOVENIJA";"11";"2010";28248;16714;11534
"102";"SLOVENIJA";"11";"2011";27166;15842;11324
"103";"SLOVENIJA";"11";"2012";26956;15901;11055
"104";"SLOVENIJA";"11";"2013";26590;15287;11303
"105";"SLOVENIJA";"11";"2014";26644;15421;11223
"106";"SLOVENIJA";"11";"2015";27078;15680;11398
"107";"SLOVENIJA";"11";"2016";27195;15821;11374
"108";"SLOVENIJA";"11";"2017 (začasni podatki)";28381;16642;11739
"109";"SLOVENIJA";"12";"2009";29958;17276;12682
"110";"SLOVENIJA";"12";"2010";28652;16662;11990
"111";"SLOVENIJA";"12";"2011";27883;16059;11824
"112";"SLOVENIJA";"12";"2012";27034;15202;11832
"113";"SLOVENIJA";"12";"2013";26488;15118;11370
"114";"SLOVENIJA";"12";"2014";27020;15697;11323
"115";"SLOVENIJA";"12";"2015";26461;15457;11004
"116";"SLOVENIJA";"12";"2016";27162;15735;11427
"117";"SLOVENIJA";"12";"2017 (začasni podatki)";27742;16043;11699
"118";"SLOVENIJA";"13";"2009";29686;16957;12729
"119";"SLOVENIJA";"13";"2010";28589;16500;12089
"120";"SLOVENIJA";"13";"2011";27357;15374;11983
"121";"SLOVENIJA";"13";"2012";26881;15238;11643
"122";"SLOVENIJA";"13";"2013";27062;15278;11784
"123";"SLOVENIJA";"13";"2014";27371;15699;11672
"124";"SLOVENIJA";"13";"2015";26651;15556;11095
"125";"SLOVENIJA";"13";"2016";27041;15642;11399
"126";"SLOVENIJA";"13";"2017 (začasni podatki)";28410;16707;11703
"127";"SLOVENIJA";"14";"2009";29754;16697;13057
"128";"SLOVENIJA";"14";"2010";28589;16115;12474
"129";"SLOVENIJA";"14";"2011";27695;15470;12225
"130";"SLOVENIJA";"14";"2012";26822;15135;11687
"131";"SLOVENIJA";"14";"2013";26451;14836;11615
"132";"SLOVENIJA";"14";"2014";27068;15430;11638
"133";"SLOVENIJA";"14";"2015";26740;15312;11428
"134";"SLOVENIJA";"14";"2016";27210;15550;11660
"135";"SLOVENIJA";"14";"2017 (začasni podatki)";28099;16014;12085
"136";"SLOVENIJA";"15";"2009";30028;16489;13539
"137";"SLOVENIJA";"15";"2010";28539;15977;12562
"138";"SLOVENIJA";"15";"2011";27577;15126;12451
"139";"SLOVENIJA";"15";"2012";26877;14854;12023
"140";"SLOVENIJA";"15";"2013";26596;14418;12178
"141";"SLOVENIJA";"15";"2014";26843;14942;11901
"142";"SLOVENIJA";"15";"2015";26839;15006;11833
"143";"SLOVENIJA";"15";"2016";26833;14625;12208
"144";"SLOVENIJA";"15";"2017 (začasni podatki)";28175;15488;12687
"145";"SLOVENIJA";"16";"2009";29754;16195;13559
"146";"SLOVENIJA";"16";"2010";28497;15337;13160
"147";"SLOVENIJA";"16";"2011";27769;14508;13261
"148";"SLOVENIJA";"16";"2012";26835;13896;12939
"149";"SLOVENIJA";"16";"2013";26712;13525;13187
"150";"SLOVENIJA";"16";"2014";27175;14072;13103
"151";"SLOVENIJA";"16";"2015";26542;13656;12886
"152";"SLOVENIJA";"16";"2016";27296;13411;13885
"153";"SLOVENIJA";"16";"2017 (začasni podatki)";27956;13959;13997
"154";"SLOVENIJA";"17";"2009";29839;14385;15454
"155";"SLOVENIJA";"17";"2010";28516;13467;15049
"156";"SLOVENIJA";"17";"2011";27560;12626;14934
"157";"SLOVENIJA";"17";"2012";26960;12439;14521
"158";"SLOVENIJA";"17";"2013";26748;12240;14508
"159";"SLOVENIJA";"17";"2014";27029;12506;14523
"160";"SLOVENIJA";"17";"2015";26695;12670;14025
"161";"SLOVENIJA";"17";"2016";27033;12458;14575
"162";"SLOVENIJA";"17";"2017 (začasni podatki)";28327;13379;14948
"163";"SLOVENIJA";"18";"2009";29886;13468;16418
"164";"SLOVENIJA";"18";"2010";28473;13051;15422
"165";"SLOVENIJA";"18";"2011";27553;12572;14981
"166";"SLOVENIJA";"18";"2012";27061;12757;14304
"167";"SLOVENIJA";"18";"2013";26578;12933;13645
"168";"SLOVENIJA";"18";"2014";26977;13357;13620
"169";"SLOVENIJA";"18";"2015";26836;13413;13423
"170";"SLOVENIJA";"18";"2016";27124;13918;13206
"171";"SLOVENIJA";"18";"2017 (začasni podatki)";28106;14735;13371
"172";"SLOVENIJA";"19";"2009";29830;15966;13864
"173";"SLOVENIJA";"19";"2010";28535;15509;13026
"174";"SLOVENIJA";"19";"2011";27666;15017;12649
"175";"SLOVENIJA";"19";"2012";26883;14871;12012
"176";"SLOVENIJA";"19";"2013";26709;14798;11911
"177";"SLOVENIJA";"19";"2014";27027;15100;11927
"178";"SLOVENIJA";"19";"2015";26643;15153;11490
"179";"SLOVENIJA";"19";"2016";27035;15327;11708
"180";"SLOVENIJA";"19";"2017 (začasni podatki)";28115;16166;11949
"181";"SLOVENIJA";"20";"2009";29887;18739;11148
"182";"SLOVENIJA";"20";"2010";28519;17822;10697
"183";"SLOVENIJA";"20";"2011";27587;17268;10319
"184";"SLOVENIJA";"20";"2012";26921;16829;10092
"185";"SLOVENIJA";"20";"2013";26646;16674;9972
"186";"SLOVENIJA";"20";"2014";27033;16969;10064
"187";"SLOVENIJA";"20";"2015";26696;16836;9860
"188";"SLOVENIJA";"20";"2016";27111;17048;10063
"189";"SLOVENIJA";"20";"2017 (začasni podatki)";28118;17450;10668
"190";"Pomurska";"Razred neto - SKUPAJ";"2009";24559;14025;10534
"191";"Pomurska";"Razred neto - SKUPAJ";"2010";24926;13597;11329
"192";"Pomurska";"Razred neto - SKUPAJ";"2011";23484;12845;10639
"193";"Pomurska";"Razred neto - SKUPAJ";"2012";23871;12846;11025
"194";"Pomurska";"Razred neto - SKUPAJ";"2013";23553;12470;11083
"195";"Pomurska";"Razred neto - SKUPAJ";"2014";22699;12484;10215
"196";"Pomurska";"Razred neto - SKUPAJ";"2015";22390;12323;10067
"197";"Pomurska";"Razred neto - SKUPAJ";"2016";23260;12593;10667
"198";"Pomurska";"Razred neto - SKUPAJ";"2017 (začasni podatki)";23710;12778;10932
"199";"Pomurska";"01";"2009";923;524;399
"200";"Pomurska";"01";"2010";1349;510;839
"201";"Pomurska";"01";"2011";1220;485;735
"202";"Pomurska";"01";"2012";1371;574;797
"203";"Pomurska";"01";"2013";1564;553;1011
"204";"Pomurska";"01";"2014";1111;500;611
"205";"Pomurska";"01";"2015";1233;521;712
"206";"Pomurska";"01";"2016";1307;480;827
"207";"Pomurska";"01";"2017 (začasni podatki)";1325;461;864
"208";"Pomurska";"02";"2009";1536;664;872
"209";"Pomurska";"02";"2010";1740;700;1040
"210";"Pomurska";"02";"2011";1469;604;865
"211";"Pomurska";"02";"2012";1535;556;979
"212";"Pomurska";"02";"2013";1546;592;954
"213";"Pomurska";"02";"2014";1206;470;736
"214";"Pomurska";"02";"2015";1348;502;846
"215";"Pomurska";"02";"2016";1495;503;992
"216";"Pomurska";"02";"2017 (začasni podatki)";1504;538;966
"217";"Pomurska";"03";"2009";1702;783;919
"218";"Pomurska";"03";"2010";1907;910;997
"219";"Pomurska";"03";"2011";1701;798;903
"220";"Pomurska";"03";"2012";1910;851;1059
"221";"Pomurska";"03";"2013";1796;786;1010
"222";"Pomurska";"03";"2014";1552;718;834
"223";"Pomurska";"03";"2015";1405;670;735
"224";"Pomurska";"03";"2016";1514;695;819
"225";"Pomurska";"03";"2017 (začasni podatki)";1442;614;828
"226";"Pomurska";"04";"2009";1553;850;703
"227";"Pomurska";"04";"2010";1677;934;743
"228";"Pomurska";"04";"2011";1602;827;775
"229";"Pomurska";"04";"2012";1595;822;773
"230";"Pomurska";"04";"2013";1434;689;745
"231";"Pomurska";"04";"2014";1506;745;761
"232";"Pomurska";"04";"2015";1471;730;741
"233";"Pomurska";"04";"2016";1528;725;803
"234";"Pomurska";"04";"2017 (začasni podatki)";1562;728;834
"235";"Pomurska";"05";"2009";1334;850;484
"236";"Pomurska";"05";"2010";1562;949;613
"237";"Pomurska";"05";"2011";1533;905;628
"238";"Pomurska";"05";"2012";1477;807;670
"239";"Pomurska";"05";"2013";1625;920;705
"240";"Pomurska";"05";"2014";1579;882;697
"241";"Pomurska";"05";"2015";1488;813;675
"242";"Pomurska";"05";"2016";1498;793;705
"243";"Pomurska";"05";"2017 (začasni podatki)";1732;921;811
"244";"Pomurska";"06";"2009";1466;995;471
"245";"Pomurska";"06";"2010";1546;1017;529
"246";"Pomurska";"06";"2011";1421;915;506
"247";"Pomurska";"06";"2012";1468;938;530
"248";"Pomurska";"06";"2013";1497;954;543
"249";"Pomurska";"06";"2014";1549;1012;537
"250";"Pomurska";"06";"2015";1477;940;537
"251";"Pomurska";"06";"2016";1544;984;560
"252";"Pomurska";"06";"2017 (začasni podatki)";1635;1051;584
"253";"Pomurska";"07";"2009";1524;1077;447
"254";"Pomurska";"07";"2010";1436;925;511
"255";"Pomurska";"07";"2011";1396;945;451
"256";"Pomurska";"07";"2012";1371;920;451
"257";"Pomurska";"07";"2013";1370;938;432
"258";"Pomurska";"07";"2014";1315;872;443
"259";"Pomurska";"07";"2015";1381;916;465
"260";"Pomurska";"07";"2016";1448;977;471
"261";"Pomurska";"07";"2017 (začasni podatki)";1432;968;464
"262";"Pomurska";"08";"2009";1521;1053;468
"263";"Pomurska";"08";"2010";1361;960;401
"264";"Pomurska";"08";"2011";1276;893;383
"265";"Pomurska";"08";"2012";1270;874;396
"266";"Pomurska";"08";"2013";1324;920;404
"267";"Pomurska";"08";"2014";1342;911;431
"268";"Pomurska";"08";"2015";1293;882;411
"269";"Pomurska";"08";"2016";1286;872;414
"270";"Pomurska";"08";"2017 (začasni podatki)";1279;857;422
"271";"Pomurska";"09";"2009";1464;996;468
"272";"Pomurska";"09";"2010";1282;841;441
"273";"Pomurska";"09";"2011";1200;806;394
"274";"Pomurska";"09";"2012";1243;817;426
"275";"Pomurska";"09";"2013";1344;887;457
"276";"Pomurska";"09";"2014";1248;793;455
"277";"Pomurska";"09";"2015";1186;794;392
"278";"Pomurska";"09";"2016";1229;806;423
"279";"Pomurska";"09";"2017 (začasni podatki)";1173;776;397
"280";"Pomurska";"10";"2009";1334;888;446
"281";"Pomurska";"10";"2010";1295;783;512
"282";"Pomurska";"10";"2011";1232;761;471
"283";"Pomurska";"10";"2012";1183;742;441
"284";"Pomurska";"10";"2013";1202;734;468
"285";"Pomurska";"10";"2014";1167;732;435
"286";"Pomurska";"10";"2015";1190;755;435
"287";"Pomurska";"10";"2016";1217;781;436
"288";"Pomurska";"10";"2017 (začasni podatki)";1216;749;467
"289";"Pomurska";"11";"2009";1190;723;467
"290";"Pomurska";"11";"2010";1147;683;464
"291";"Pomurska";"11";"2011";1128;698;430
"292";"Pomurska";"11";"2012";1120;679;441
"293";"Pomurska";"11";"2013";1025;616;409
"294";"Pomurska";"11";"2014";1090;648;442
"295";"Pomurska";"11";"2015";1140;674;466
"296";"Pomurska";"11";"2016";1065;636;429
"297";"Pomurska";"11";"2017 (začasni podatki)";1077;657;420
"298";"Pomurska";"12";"2009";1136;675;461
"299";"Pomurska";"12";"2010";1095;645;450
"300";"Pomurska";"12";"2011";1037;599;438
"301";"Pomurska";"12";"2012";1134;648;486
"302";"Pomurska";"12";"2013";991;527;464
"303";"Pomurska";"12";"2014";1008;559;449
"304";"Pomurska";"12";"2015";979;574;405
"305";"Pomurska";"12";"2016";1040;608;432
"306";"Pomurska";"12";"2017 (začasni podatki)";1082;633;449
"307";"Pomurska";"13";"2009";1065;610;455
"308";"Pomurska";"13";"2010";988;563;425
"309";"Pomurska";"13";"2011";988;557;431
"310";"Pomurska";"13";"2012";1015;568;447
"311";"Pomurska";"13";"2013";958;527;431
"312";"Pomurska";"13";"2014";967;566;401
"313";"Pomurska";"13";"2015";942;565;377
"314";"Pomurska";"13";"2016";1010;596;414
"315";"Pomurska";"13";"2017 (začasni podatki)";995;594;401
"316";"Pomurska";"14";"2009";1080;551;529
"317";"Pomurska";"14";"2010";1031;516;515
"318";"Pomurska";"14";"2011";995;517;478
"319";"Pomurska";"14";"2012";977;516;461
"320";"Pomurska";"14";"2013";915;458;457
"321";"Pomurska";"14";"2014";993;530;463
"322";"Pomurska";"14";"2015";971;543;428
"323";"Pomurska";"14";"2016";976;538;438
"324";"Pomurska";"14";"2017 (začasni podatki)";1029;574;455
"325";"Pomurska";"15";"2009";1061;548;513
"326";"Pomurska";"15";"2010";1025;551;474
"327";"Pomurska";"15";"2011";976;504;472
"328";"Pomurska";"15";"2012";976;519;457
"329";"Pomurska";"15";"2013";903;455;448
"330";"Pomurska";"15";"2014";937;514;423
"331";"Pomurska";"15";"2015";921;504;417
"332";"Pomurska";"15";"2016";926;521;405
"333";"Pomurska";"15";"2017 (začasni podatki)";1000;546;454
"334";"Pomurska";"16";"2009";1055;551;504
"335";"Pomurska";"16";"2010";1007;509;498
"336";"Pomurska";"16";"2011";980;486;494
"337";"Pomurska";"16";"2012";968;465;503
"338";"Pomurska";"16";"2013";915;398;517
"339";"Pomurska";"16";"2014";920;433;487
"340";"Pomurska";"16";"2015";913;453;460
"341";"Pomurska";"16";"2016";1010;465;545
"342";"Pomurska";"16";"2017 (začasni podatki)";954;429;525
"343";"Pomurska";"17";"2009";987;446;541
"344";"Pomurska";"17";"2010";974;408;566
"345";"Pomurska";"17";"2011";932;398;534
"346";"Pomurska";"17";"2012";894;382;512
"347";"Pomurska";"17";"2013";863;347;516
"348";"Pomurska";"17";"2014";894;380;514
"349";"Pomurska";"17";"2015";885;363;522
"350";"Pomurska";"17";"2016";970;414;556
"351";"Pomurska";"17";"2017 (začasni podatki)";1004;437;567
"352";"Pomurska";"18";"2009";1042;381;661
"353";"Pomurska";"18";"2010";1006;366;640
"354";"Pomurska";"18";"2011";996;372;624
"355";"Pomurska";"18";"2012";967;378;589
"356";"Pomurska";"18";"2013";920;375;545
"357";"Pomurska";"18";"2014";952;416;536
"358";"Pomurska";"18";"2015";881;372;509
"359";"Pomurska";"18";"2016";884;400;484
"360";"Pomurska";"18";"2017 (začasni podatki)";921;414;507
"361";"Pomurska";"19";"2009";903;438;465
"362";"Pomurska";"19";"2010";834;414;420
"363";"Pomurska";"19";"2011";787;381;406
"364";"Pomurska";"19";"2012";780;392;388
"365";"Pomurska";"19";"2013";759;393;366
"366";"Pomurska";"19";"2014";766;397;369
"367";"Pomurska";"19";"2015";719;360;359
"368";"Pomurska";"19";"2016";724;386;338
"369";"Pomurska";"19";"2017 (začasni podatki)";746;415;331
"370";"Pomurska";"20";"2009";683;422;261
"371";"Pomurska";"20";"2010";664;413;251
"372";"Pomurska";"20";"2011";615;394;221
"373";"Pomurska";"20";"2012";617;398;219
"374";"Pomurska";"20";"2013";602;401;201
"375";"Pomurska";"20";"2014";597;406;191
"376";"Pomurska";"20";"2015";567;392;175
"377";"Pomurska";"20";"2016";589;413;176
"378";"Pomurska";"20";"2017 (začasni podatki)";602;416;186
"379";"Podravska";"Razred neto - SKUPAJ";"2009";85233;46633;38600
"380";"Podravska";"Razred neto - SKUPAJ";"2010";80202;43347;36855
"381";"Podravska";"Razred neto - SKUPAJ";"2011";76118;39370;36748
"382";"Podravska";"Razred neto - SKUPAJ";"2012";73493;38104;35389
"383";"Podravska";"Razred neto - SKUPAJ";"2013";71545;36665;34880
"384";"Podravska";"Razred neto - SKUPAJ";"2014";73274;38267;35007
"385";"Podravska";"Razred neto - SKUPAJ";"2015";71915;37722;34193
"386";"Podravska";"Razred neto - SKUPAJ";"2016";74410;38798;35612
"387";"Podravska";"Razred neto - SKUPAJ";"2017 (začasni podatki)";76171;39875;36296
"388";"Podravska";"01";"2009";4686;2262;2424
"389";"Podravska";"01";"2010";4396;1859;2537
"390";"Podravska";"01";"2011";4321;1672;2649
"391";"Podravska";"01";"2012";4251;1893;2358
"392";"Podravska";"01";"2013";4036;1712;2324
"393";"Podravska";"01";"2014";4215;1753;2462
"394";"Podravska";"01";"2015";4142;1784;2358
"395";"Podravska";"01";"2016";4371;1845;2526
"396";"Podravska";"01";"2017 (začasni podatki)";4494;1878;2616
"397";"Podravska";"02";"2009";4595;2017;2578
"398";"Podravska";"02";"2010";4417;2096;2321
"399";"Podravska";"02";"2011";4968;2021;2947
"400";"Podravska";"02";"2012";4347;1695;2652
"401";"Podravska";"02";"2013";4592;1740;2852
"402";"Podravska";"02";"2014";4498;1719;2779
"403";"Podravska";"02";"2015";4673;1837;2836
"404";"Podravska";"02";"2016";4857;1808;3049
"405";"Podravska";"02";"2017 (začasni podatki)";5027;1956;3071
"406";"Podravska";"03";"2009";5099;2289;2810
"407";"Podravska";"03";"2010";4933;2327;2606
"408";"Podravska";"03";"2011";4885;2332;2553
"409";"Podravska";"03";"2012";4889;2219;2670
"410";"Podravska";"03";"2013";4523;2099;2424
"411";"Podravska";"03";"2014";5105;2259;2846
"412";"Podravska";"03";"2015";4650;2172;2478
"413";"Podravska";"03";"2016";4940;2117;2823
"414";"Podravska";"03";"2017 (začasni podatki)";4583;1935;2648
"415";"Podravska";"04";"2009";4995;2323;2672
"416";"Podravska";"04";"2010";4763;2313;2450
"417";"Podravska";"04";"2011";4248;2023;2225
"418";"Podravska";"04";"2012";4201;2011;2190
"419";"Podravska";"04";"2013";4280;2028;2252
"420";"Podravska";"04";"2014";4176;2004;2172
"421";"Podravska";"04";"2015";4138;1950;2188
"422";"Podravska";"04";"2016";4299;1969;2330
"423";"Podravska";"04";"2017 (začasni podatki)";4163;1906;2257
"424";"Podravska";"05";"2009";4500;2460;2040
"425";"Podravska";"05";"2010";4304;2399;1905
"426";"Podravska";"05";"2011";3876;2066;1810
"427";"Podravska";"05";"2012";3844;1938;1906
"428";"Podravska";"05";"2013";3932;1994;1938
"429";"Podravska";"05";"2014";3915;1997;1918
"430";"Podravska";"05";"2015";3759;1939;1820
"431";"Podravska";"05";"2016";3716;1981;1735
"432";"Podravska";"05";"2017 (začasni podatki)";4085;2140;1945
"433";"Podravska";"06";"2009";4470;2621;1849
"434";"Podravska";"06";"2010";4340;2523;1817
"435";"Podravska";"06";"2011";3959;2167;1792
"436";"Podravska";"06";"2012";3856;2041;1815
"437";"Podravska";"06";"2013";3697;1964;1733
"438";"Podravska";"06";"2014";3650;2052;1598
"439";"Podravska";"06";"2015";3614;1991;1623
"440";"Podravska";"06";"2016";3866;2196;1670
"441";"Podravska";"06";"2017 (začasni podatki)";3999;2181;1818
"442";"Podravska";"07";"2009";4604;2867;1737
"443";"Podravska";"07";"2010";4387;2684;1703
"444";"Podravska";"07";"2011";4107;2367;1740
"445";"Podravska";"07";"2012";3853;2179;1674
"446";"Podravska";"07";"2013";3673;2022;1651
"447";"Podravska";"07";"2014";3673;2101;1572
"448";"Podravska";"07";"2015";3676;2121;1555
"449";"Podravska";"07";"2016";3974;2324;1650
"450";"Podravska";"07";"2017 (začasni podatki)";3928;2333;1595
"451";"Podravska";"08";"2009";4948;3221;1727
"452";"Podravska";"08";"2010";4394;2790;1604
"453";"Podravska";"08";"2011";3890;2309;1581
"454";"Podravska";"08";"2012";3825;2301;1524
"455";"Podravska";"08";"2013";3533;2114;1419
"456";"Podravska";"08";"2014";3794;2287;1507
"457";"Podravska";"08";"2015";3779;2321;1458
"458";"Podravska";"08";"2016";3967;2349;1618
"459";"Podravska";"08";"2017 (začasni podatki)";3988;2449;1539
"460";"Podravska";"09";"2009";4724;3171;1553
"461";"Podravska";"09";"2010";4183;2634;1549
"462";"Podravska";"09";"2011";3824;2295;1529
"463";"Podravska";"09";"2012";3652;2221;1431
"464";"Podravska";"09";"2013";3600;2196;1404
"465";"Podravska";"09";"2014";3657;2230;1427
"466";"Podravska";"09";"2015";3641;2208;1433
"467";"Podravska";"09";"2016";3886;2363;1523
"468";"Podravska";"09";"2017 (začasni podatki)";3946;2452;1494
"469";"Podravska";"10";"2009";4353;2888;1465
"470";"Podravska";"10";"2010";4012;2498;1514
"471";"Podravska";"10";"2011";3720;2248;1472
"472";"Podravska";"10";"2012";3619;2234;1385
"473";"Podravska";"10";"2013";3626;2161;1465
"474";"Podravska";"10";"2014";3728;2257;1471
"475";"Podravska";"10";"2015";3668;2170;1498
"476";"Podravska";"10";"2016";3679;2238;1441
"477";"Podravska";"10";"2017 (začasni podatki)";3890;2314;1576
"478";"Podravska";"11";"2009";4239;2627;1612
"479";"Podravska";"11";"2010";3879;2290;1589
"480";"Podravska";"11";"2011";3730;2174;1556
"481";"Podravska";"11";"2012";3642;2145;1497
"482";"Podravska";"11";"2013";3548;2016;1532
"483";"Podravska";"11";"2014";3543;2112;1431
"484";"Podravska";"11";"2015";3595;2142;1453
"485";"Podravska";"11";"2016";3720;2233;1487
"486";"Podravska";"11";"2017 (začasni podatki)";3808;2297;1511
"487";"Podravska";"12";"2009";4210;2421;1789
"488";"Podravska";"12";"2010";3941;2262;1679
"489";"Podravska";"12";"2011";3612;2044;1568
"490";"Podravska";"12";"2012";3579;1990;1589
"491";"Podravska";"12";"2013";3341;1930;1411
"492";"Podravska";"12";"2014";3582;2157;1425
"493";"Podravska";"12";"2015";3467;2044;1423
"494";"Podravska";"12";"2016";3562;2104;1458
"495";"Podravska";"12";"2017 (začasni podatki)";3511;2055;1456
"496";"Podravska";"13";"2009";4011;2271;1740
"497";"Podravska";"13";"2010";3731;2133;1598
"498";"Podravska";"13";"2011";3460;1874;1586
"499";"Podravska";"13";"2012";3344;1881;1463
"500";"Podravska";"13";"2013";3369;1853;1516
"501";"Podravska";"13";"2014";3517;2011;1506
"502";"Podravska";"13";"2015";3415;1942;1473
"503";"Podravska";"13";"2016";3454;2032;1422
"504";"Podravska";"13";"2017 (začasni podatki)";3670;2136;1534
"505";"Podravska";"14";"2009";3921;2185;1736
"506";"Podravska";"14";"2010";3712;2061;1651
"507";"Podravska";"14";"2011";3479;1868;1611
"508";"Podravska";"14";"2012";3424;1861;1563
"509";"Podravska";"14";"2013";3148;1673;1475
"510";"Podravska";"14";"2014";3325;1830;1495
"511";"Podravska";"14";"2015";3289;1787;1502
"512";"Podravska";"14";"2016";3396;1913;1483
"513";"Podravska";"14";"2017 (začasni podatki)";3510;1961;1549
"514";"Podravska";"15";"2009";3840;2067;1773
"515";"Podravska";"15";"2010";3744;2018;1726
"516";"Podravska";"15";"2011";3563;1848;1715
"517";"Podravska";"15";"2012";3497;1834;1663
"518";"Podravska";"15";"2013";3310;1675;1635
"519";"Podravska";"15";"2014";3348;1744;1604
"520";"Podravska";"15";"2015";3329;1767;1562
"521";"Podravska";"15";"2016";3395;1715;1680
"522";"Podravska";"15";"2017 (začasni podatki)";3498;1789;1709
"523";"Podravska";"16";"2009";4000;2015;1985
"524";"Podravska";"16";"2010";3866;1997;1869
"525";"Podravska";"16";"2011";3753;1899;1854
"526";"Podravska";"16";"2012";3454;1665;1789
"527";"Podravska";"16";"2013";3369;1590;1779
"528";"Podravska";"16";"2014";3535;1738;1797
"529";"Podravska";"16";"2015";3337;1620;1717
"530";"Podravska";"16";"2016";3426;1536;1890
"531";"Podravska";"16";"2017 (začasni podatki)";3581;1662;1919
"532";"Podravska";"17";"2009";3933;1820;2113
"533";"Podravska";"17";"2010";3737;1632;2105
"534";"Podravska";"17";"2011";3612;1498;2114
"535";"Podravska";"17";"2012";3504;1442;2062
"536";"Podravska";"17";"2013";3449;1364;2085
"537";"Podravska";"17";"2014";3515;1432;2083
"538";"Podravska";"17";"2015";3421;1420;2001
"539";"Podravska";"17";"2016";3545;1466;2079
"540";"Podravska";"17";"2017 (začasni podatki)";3730;1583;2147
"541";"Podravska";"18";"2009";3921;1558;2363
"542";"Podravska";"18";"2010";3601;1434;2167
"543";"Podravska";"18";"2011";3446;1362;2084
"544";"Podravska";"18";"2012";3203;1336;1867
"545";"Podravska";"18";"2013";3135;1370;1765
"546";"Podravska";"18";"2014";3128;1398;1730
"547";"Podravska";"18";"2015";3156;1423;1733
"548";"Podravska";"18";"2016";3198;1546;1652
"549";"Podravska";"18";"2017 (začasni podatki)";3220;1542;1678
"550";"Podravska";"19";"2009";3166;1621;1545
"551";"Podravska";"19";"2010";3072;1636;1436
"552";"Podravska";"19";"2011";3014;1619;1395
"553";"Podravska";"19";"2012";2887;1559;1328
"554";"Podravska";"19";"2013";2792;1502;1290
"555";"Podravska";"19";"2014";2803;1507;1296
"556";"Podravska";"19";"2015";2689;1478;1211
"557";"Podravska";"19";"2016";2662;1454;1208
"558";"Podravska";"19";"2017 (začasni podatki)";2816;1587;1229
"559";"Podravska";"20";"2009";3018;1929;1089
"560";"Podravska";"20";"2010";2790;1761;1029
"561";"Podravska";"20";"2011";2651;1684;967
"562";"Podravska";"20";"2012";2622;1659;963
"563";"Podravska";"20";"2013";2592;1662;930
"564";"Podravska";"20";"2014";2567;1679;888
"565";"Podravska";"20";"2015";2477;1606;871
"566";"Podravska";"20";"2016";2497;1609;888
"567";"Podravska";"20";"2017 (začasni podatki)";2724;1719;1005
"568";"Koroška";"Razred neto - SKUPAJ";"2009";18409;10150;8259
"569";"Koroška";"Razred neto - SKUPAJ";"2010";16621;9517;7104
"570";"Koroška";"Razred neto - SKUPAJ";"2011";16467;9314;7153
"571";"Koroška";"Razred neto - SKUPAJ";"2012";16493;9437;7056
"572";"Koroška";"Razred neto - SKUPAJ";"2013";16199;9073;7126
"573";"Koroška";"Razred neto - SKUPAJ";"2014";16175;9214;6961
"574";"Koroška";"Razred neto - SKUPAJ";"2015";15613;8768;6845
"575";"Koroška";"Razred neto - SKUPAJ";"2016";15680;8776;6904
"576";"Koroška";"Razred neto - SKUPAJ";"2017 (začasni podatki)";15844;8804;7040
"577";"Koroška";"01";"2009";697;338;359
"578";"Koroška";"01";"2010";646;323;323
"579";"Koroška";"01";"2011";666;321;345
"580";"Koroška";"01";"2012";827;392;435
"581";"Koroška";"01";"2013";747;331;416
"582";"Koroška";"01";"2014";767;316;451
"583";"Koroška";"01";"2015";760;313;447
"584";"Koroška";"01";"2016";685;299;386
"585";"Koroška";"01";"2017 (začasni podatki)";737;316;421
"586";"Koroška";"02";"2009";1064;340;724
"587";"Koroška";"02";"2010";741;283;458
"588";"Koroška";"02";"2011";833;331;502
"589";"Koroška";"02";"2012";700;281;419
"590";"Koroška";"02";"2013";804;312;492
"591";"Koroška";"02";"2014";693;277;416
"592";"Koroška";"02";"2015";656;280;376
"593";"Koroška";"02";"2016";643;231;412
"594";"Koroška";"02";"2017 (začasni podatki)";650;216;434
"595";"Koroška";"03";"2009";1076;390;686
"596";"Koroška";"03";"2010";880;382;498
"597";"Koroška";"03";"2011";765;352;413
"598";"Koroška";"03";"2012";741;379;362
"599";"Koroška";"03";"2013";629;299;330
"600";"Koroška";"03";"2014";700;309;391
"601";"Koroška";"03";"2015";671;284;387
"602";"Koroška";"03";"2016";680;286;394
"603";"Koroška";"03";"2017 (začasni podatki)";670;269;401
"604";"Koroška";"04";"2009";1106;495;611
"605";"Koroška";"04";"2010";861;425;436
"606";"Koroška";"04";"2011";800;396;404
"607";"Koroška";"04";"2012";845;392;453
"608";"Koroška";"04";"2013";768;317;451
"609";"Koroška";"04";"2014";773;356;417
"610";"Koroška";"04";"2015";706;299;407
"611";"Koroška";"04";"2016";664;271;393
"612";"Koroška";"04";"2017 (začasni podatki)";772;328;444
"613";"Koroška";"05";"2009";1101;623;478
"614";"Koroška";"05";"2010";901;513;388
"615";"Koroška";"05";"2011";891;469;422
"616";"Koroška";"05";"2012";857;444;413
"617";"Koroška";"05";"2013";888;457;431
"618";"Koroška";"05";"2014";973;522;451
"619";"Koroška";"05";"2015";850;427;423
"620";"Koroška";"05";"2016";808;361;447
"621";"Koroška";"05";"2017 (začasni podatki)";782;368;414
"622";"Koroška";"06";"2009";1160;685;475
"623";"Koroška";"06";"2010";1024;642;382
"624";"Koroška";"06";"2011";892;498;394
"625";"Koroška";"06";"2012";971;549;422
"626";"Koroška";"06";"2013";1029;570;459
"627";"Koroška";"06";"2014";965;532;433
"628";"Koroška";"06";"2015";906;505;401
"629";"Koroška";"06";"2016";907;484;423
"630";"Koroška";"06";"2017 (začasni podatki)";846;446;400
"631";"Koroška";"07";"2009";1240;769;471
"632";"Koroška";"07";"2010";1070;692;378
"633";"Koroška";"07";"2011";943;575;368
"634";"Koroška";"07";"2012";990;614;376
"635";"Koroška";"07";"2013";975;567;408
"636";"Koroška";"07";"2014";984;604;380
"637";"Koroška";"07";"2015";889;500;389
"638";"Koroška";"07";"2016";939;552;387
"639";"Koroška";"07";"2017 (začasni podatki)";947;541;406
"640";"Koroška";"08";"2009";1198;797;401
"641";"Koroška";"08";"2010";1096;721;375
"642";"Koroška";"08";"2011";1050;669;381
"643";"Koroška";"08";"2012";1011;645;366
"644";"Koroška";"08";"2013";991;645;346
"645";"Koroška";"08";"2014";970;611;359
"646";"Koroška";"08";"2015";960;600;360
"647";"Koroška";"08";"2016";953;591;362
"648";"Koroška";"08";"2017 (začasni podatki)";946;595;351
"649";"Koroška";"09";"2009";1154;818;336
"650";"Koroška";"09";"2010";1098;758;340
"651";"Koroška";"09";"2011";1085;726;359
"652";"Koroška";"09";"2012";1113;778;335
"653";"Koroška";"09";"2013";973;649;324
"654";"Koroška";"09";"2014";986;682;304
"655";"Koroška";"09";"2015";1010;655;355
"656";"Koroška";"09";"2016";988;677;311
"657";"Koroška";"09";"2017 (začasni podatki)";985;633;352
"658";"Koroška";"10";"2009";1029;711;318
"659";"Koroška";"10";"2010";1043;740;303
"660";"Koroška";"10";"2011";1024;690;334
"661";"Koroška";"10";"2012";988;663;325
"662";"Koroška";"10";"2013";1021;706;315
"663";"Koroška";"10";"2014";1065;743;322
"664";"Koroška";"10";"2015";916;616;300
"665";"Koroška";"10";"2016";1018;667;351
"666";"Koroška";"10";"2017 (začasni podatki)";943;613;330
"667";"Koroška";"11";"2009";971;674;297
"668";"Koroška";"11";"2010";914;602;312
"669";"Koroška";"11";"2011";978;644;334
"670";"Koroška";"11";"2012";1031;693;338
"671";"Koroška";"11";"2013";1049;671;378
"672";"Koroška";"11";"2014";968;645;323
"673";"Koroška";"11";"2015";986;626;360
"674";"Koroška";"11";"2016";1001;665;336
"675";"Koroška";"11";"2017 (začasni podatki)";980;654;326
"676";"Koroška";"12";"2009";991;631;360
"677";"Koroška";"12";"2010";946;605;341
"678";"Koroška";"12";"2011";944;609;335
"679";"Koroška";"12";"2012";939;607;332
"680";"Koroška";"12";"2013";961;638;323
"681";"Koroška";"12";"2014";975;641;334
"682";"Koroška";"12";"2015";934;631;303
"683";"Koroška";"12";"2016";924;596;328
"684";"Koroška";"12";"2017 (začasni podatki)";912;571;341
"685";"Koroška";"13";"2009";828;499;329
"686";"Koroška";"13";"2010";854;523;331
"687";"Koroška";"13";"2011";878;550;328
"688";"Koroška";"13";"2012";849;550;299
"689";"Koroška";"13";"2013";888;555;333
"690";"Koroška";"13";"2014";912;616;296
"691";"Koroška";"13";"2015";907;615;292
"692";"Koroška";"13";"2016";967;662;305
"693";"Koroška";"13";"2017 (začasni podatki)";974;647;327
"694";"Koroška";"14";"2009";782;458;324
"695";"Koroška";"14";"2010";839;490;349
"696";"Koroška";"14";"2011";876;556;320
"697";"Koroška";"14";"2012";864;542;322
"698";"Koroška";"14";"2013";833;546;287
"699";"Koroška";"14";"2014";889;561;328
"700";"Koroška";"14";"2015";831;539;292
"701";"Koroška";"14";"2016";821;527;294
"702";"Koroška";"14";"2017 (začasni podatki)";873;578;295
"703";"Koroška";"15";"2009";781;418;363
"704";"Koroška";"15";"2010";728;435;293
"705";"Koroška";"15";"2011";769;449;320
"706";"Koroška";"15";"2012";764;467;297
"707";"Koroška";"15";"2013";734;414;320
"708";"Koroška";"15";"2014";676;405;271
"709";"Koroška";"15";"2015";748;445;303
"710";"Koroška";"15";"2016";704;419;285
"711";"Koroška";"15";"2017 (začasni podatki)";771;468;303
"712";"Koroška";"16";"2009";725;371;354
"713";"Koroška";"16";"2010";670;324;346
"714";"Koroška";"16";"2011";690;360;330
"715";"Koroška";"16";"2012";651;314;337
"716";"Koroška";"16";"2013";630;310;320
"717";"Koroška";"16";"2014";616;307;309
"718";"Koroška";"16";"2015";605;310;295
"719";"Koroška";"16";"2016";719;361;358
"720";"Koroška";"16";"2017 (začasni podatki)";718;366;352
"721";"Koroška";"17";"2009";730;304;426
"722";"Koroška";"17";"2010";683;277;406
"723";"Koroška";"17";"2011";715;290;425
"724";"Koroška";"17";"2012";705;283;422
"725";"Koroška";"17";"2013";679;268;411
"726";"Koroška";"17";"2014";651;243;408
"727";"Koroška";"17";"2015";710;297;413
"728";"Koroška";"17";"2016";712;283;429
"729";"Koroška";"17";"2017 (začasni podatki)";766;335;431
"730";"Koroška";"18";"2009";745;273;472
"731";"Koroška";"18";"2010";653;246;407
"732";"Koroška";"18";"2011";688;282;406
"733";"Koroška";"18";"2012";652;287;365
"734";"Koroška";"18";"2013";600;264;336
"735";"Koroška";"18";"2014";621;287;334
"736";"Koroška";"18";"2015";581;261;320
"737";"Koroška";"18";"2016";566;276;290
"738";"Koroška";"18";"2017 (začasni podatki)";560;277;283
"739";"Koroška";"19";"2009";530;256;274
"740";"Koroška";"19";"2010";520;265;255
"741";"Koroška";"19";"2011";533;273;260
"742";"Koroška";"19";"2012";524;275;249
"743";"Koroška";"19";"2013";518;264;254
"744";"Koroška";"19";"2014";514;259;255
"745";"Koroška";"19";"2015";511;264;247
"746";"Koroška";"19";"2016";516;283;233
"747";"Koroška";"19";"2017 (začasni podatki)";519;271;248
"748";"Koroška";"20";"2009";501;300;201
"749";"Koroška";"20";"2010";454;271;183
"750";"Koroška";"20";"2011";447;274;173
"751";"Koroška";"20";"2012";471;282;189
"752";"Koroška";"20";"2013";482;290;192
"753";"Koroška";"20";"2014";477;298;179
"754";"Koroška";"20";"2015";476;301;175
"755";"Koroška";"20";"2016";465;285;180
"756";"Koroška";"20";"2017 (začasni podatki)";493;312;181
"757";"Savinjska";"Razred neto - SKUPAJ";"2009";75943;43432;32511
"758";"Savinjska";"Razred neto - SKUPAJ";"2010";70959;39505;31454
"759";"Savinjska";"Razred neto - SKUPAJ";"2011";69949;38493;31456
"760";"Savinjska";"Razred neto - SKUPAJ";"2012";67083;36507;30576
"761";"Savinjska";"Razred neto - SKUPAJ";"2013";66081;36155;29926
"762";"Savinjska";"Razred neto - SKUPAJ";"2014";66568;36930;29638
"763";"Savinjska";"Razred neto - SKUPAJ";"2015";64790;36000;28790
"764";"Savinjska";"Razred neto - SKUPAJ";"2016";64033;35246;28787
"765";"Savinjska";"Razred neto - SKUPAJ";"2017 (začasni podatki)";67163;37086;30077
"766";"Savinjska";"01";"2009";4128;2758;1370
"767";"Savinjska";"01";"2010";3824;2250;1574
"768";"Savinjska";"01";"2011";3706;1988;1718
"769";"Savinjska";"01";"2012";3748;1930;1818
"770";"Savinjska";"01";"2013";3799;1990;1809
"771";"Savinjska";"01";"2014";3654;1922;1732
"772";"Savinjska";"01";"2015";3573;1852;1721
"773";"Savinjska";"01";"2016";3287;1766;1521
"774";"Savinjska";"01";"2017 (začasni podatki)";3437;1884;1553
"775";"Savinjska";"02";"2009";4526;2540;1986
"776";"Savinjska";"02";"2010";3675;1841;1834
"777";"Savinjska";"02";"2011";4222;2139;2083
"778";"Savinjska";"02";"2012";3541;1652;1889
"779";"Savinjska";"02";"2013";3448;1516;1932
"780";"Savinjska";"02";"2014";3119;1354;1765
"781";"Savinjska";"02";"2015";3155;1357;1798
"782";"Savinjska";"02";"2016";3246;1469;1777
"783";"Savinjska";"02";"2017 (začasni podatki)";3409;1576;1833
"784";"Savinjska";"03";"2009";4888;2180;2708
"785";"Savinjska";"03";"2010";3958;1833;2125
"786";"Savinjska";"03";"2011";3637;1721;1916
"787";"Savinjska";"03";"2012";3718;1742;1976
"788";"Savinjska";"03";"2013";3473;1749;1724
"789";"Savinjska";"03";"2014";3820;1958;1862
"790";"Savinjska";"03";"2015";3300;1635;1665
"791";"Savinjska";"03";"2016";3476;1659;1817
"792";"Savinjska";"03";"2017 (začasni podatki)";3637;1668;1969
"793";"Savinjska";"04";"2009";4954;2226;2728
"794";"Savinjska";"04";"2010";4226;1881;2345
"795";"Savinjska";"04";"2011";4217;1872;2345
"796";"Savinjska";"04";"2012";3977;1813;2164
"797";"Savinjska";"04";"2013";3669;1692;1977
"798";"Savinjska";"04";"2014";3827;1768;2059
"799";"Savinjska";"04";"2015";3827;1698;2129
"800";"Savinjska";"04";"2016";3625;1579;2046
"801";"Savinjska";"04";"2017 (začasni podatki)";3766;1577;2189
"802";"Savinjska";"05";"2009";4720;2384;2336
"803";"Savinjska";"05";"2010";4557;2075;2482
"804";"Savinjska";"05";"2011";4316;1997;2319
"805";"Savinjska";"05";"2012";4184;1884;2300
"806";"Savinjska";"05";"2013";3897;1799;2098
"807";"Savinjska";"05";"2014";3959;1836;2123
"808";"Savinjska";"05";"2015";3785;1739;2046
"809";"Savinjska";"05";"2016";3836;1795;2041
"810";"Savinjska";"05";"2017 (začasni podatki)";3908;1822;2086
"811";"Savinjska";"06";"2009";4519;2519;2000
"812";"Savinjska";"06";"2010";4363;2211;2152
"813";"Savinjska";"06";"2011";4274;2078;2196
"814";"Savinjska";"06";"2012";4171;2019;2152
"815";"Savinjska";"06";"2013";3976;1979;1997
"816";"Savinjska";"06";"2014";3981;1976;2005
"817";"Savinjska";"06";"2015";3680;1890;1790
"818";"Savinjska";"06";"2016";3917;1979;1938
"819";"Savinjska";"06";"2017 (začasni podatki)";4109;2042;2067
"820";"Savinjska";"07";"2009";4206;2529;1677
"821";"Savinjska";"07";"2010";4081;2290;1791
"822";"Savinjska";"07";"2011";4016;2196;1820
"823";"Savinjska";"07";"2012";3892;2161;1731
"824";"Savinjska";"07";"2013";3919;2065;1854
"825";"Savinjska";"07";"2014";3927;2220;1707
"826";"Savinjska";"07";"2015";3832;2101;1731
"827";"Savinjska";"07";"2016";3791;2088;1703
"828";"Savinjska";"07";"2017 (začasni podatki)";3932;2156;1776
"829";"Savinjska";"08";"2009";4065;2564;1501
"830";"Savinjska";"08";"2010";3718;2297;1421
"831";"Savinjska";"08";"2011";3902;2406;1496
"832";"Savinjska";"08";"2012";3599;2222;1377
"833";"Savinjska";"08";"2013";3612;2138;1474
"834";"Savinjska";"08";"2014";3713;2196;1517
"835";"Savinjska";"08";"2015";3959;2358;1601
"836";"Savinjska";"08";"2016";3830;2321;1509
"837";"Savinjska";"08";"2017 (začasni podatki)";3843;2269;1574
"838";"Savinjska";"09";"2009";3886;2576;1310
"839";"Savinjska";"09";"2010";3552;2241;1311
"840";"Savinjska";"09";"2011";3552;2216;1336
"841";"Savinjska";"09";"2012";3572;2188;1384
"842";"Savinjska";"09";"2013";3573;2150;1423
"843";"Savinjska";"09";"2014";3610;2214;1396
"844";"Savinjska";"09";"2015";3419;2092;1327
"845";"Savinjska";"09";"2016";3428;2105;1323
"846";"Savinjska";"09";"2017 (začasni podatki)";3740;2263;1477
"847";"Savinjska";"10";"2009";3808;2482;1326
"848";"Savinjska";"10";"2010";3824;2421;1403
"849";"Savinjska";"10";"2011";3606;2257;1349
"850";"Savinjska";"10";"2012";3460;2161;1299
"851";"Savinjska";"10";"2013";3343;2043;1300
"852";"Savinjska";"10";"2014";3498;2166;1332
"853";"Savinjska";"10";"2015";3506;2139;1367
"854";"Savinjska";"10";"2016";3301;2049;1252
"855";"Savinjska";"10";"2017 (začasni podatki)";3459;2077;1382
"856";"Savinjska";"11";"2009";3884;2495;1389
"857";"Savinjska";"11";"2010";3651;2307;1344
"858";"Savinjska";"11";"2011";3463;2097;1366
"859";"Savinjska";"11";"2012";3290;2005;1285
"860";"Savinjska";"11";"2013";3265;1966;1299
"861";"Savinjska";"11";"2014";3266;1956;1310
"862";"Savinjska";"11";"2015";3344;2035;1309
"863";"Savinjska";"11";"2016";3269;1983;1286
"864";"Savinjska";"11";"2017 (začasni podatki)";3544;2225;1319
"865";"Savinjska";"12";"2009";3658;2211;1447
"866";"Savinjska";"12";"2010";3517;2166;1351
"867";"Savinjska";"12";"2011";3374;2089;1285
"868";"Savinjska";"12";"2012";3232;1914;1318
"869";"Savinjska";"12";"2013";3212;1928;1284
"870";"Savinjska";"12";"2014";3328;2056;1272
"871";"Savinjska";"12";"2015";3256;2095;1161
"872";"Savinjska";"12";"2016";3215;2009;1206
"873";"Savinjska";"12";"2017 (začasni podatki)";3397;2070;1327
"874";"Savinjska";"13";"2009";3440;2073;1367
"875";"Savinjska";"13";"2010";3389;2033;1356
"876";"Savinjska";"13";"2011";3271;1976;1295
"877";"Savinjska";"13";"2012";3180;1940;1240
"878";"Savinjska";"13";"2013";3301;1957;1344
"879";"Savinjska";"13";"2014";3258;1999;1259
"880";"Savinjska";"13";"2015";3142;1980;1162
"881";"Savinjska";"13";"2016";3138;1903;1235
"882";"Savinjska";"13";"2017 (začasni podatki)";3382;2129;1253
"883";"Savinjska";"14";"2009";3202;1855;1347
"884";"Savinjska";"14";"2010";3277;1926;1351
"885";"Savinjska";"14";"2011";3259;1903;1356
"886";"Savinjska";"14";"2012";3047;1731;1316
"887";"Savinjska";"14";"2013";3175;1891;1284
"888";"Savinjska";"14";"2014";3148;1881;1267
"889";"Savinjska";"14";"2015";3097;1891;1206
"890";"Savinjska";"14";"2016";3040;1807;1233
"891";"Savinjska";"14";"2017 (začasni podatki)";3199;1966;1233
"892";"Savinjska";"15";"2009";3267;1822;1445
"893";"Savinjska";"15";"2010";3084;1774;1310
"894";"Savinjska";"15";"2011";3052;1719;1333
"895";"Savinjska";"15";"2012";2890;1659;1231
"896";"Savinjska";"15";"2013";2959;1689;1270
"897";"Savinjska";"15";"2014";2980;1720;1260
"898";"Savinjska";"15";"2015";2957;1728;1229
"899";"Savinjska";"15";"2016";2877;1633;1244
"900";"Savinjska";"15";"2017 (začasni podatki)";3101;1809;1292
"901";"Savinjska";"16";"2009";3180;1854;1326
"902";"Savinjska";"16";"2010";3051;1766;1285
"903";"Savinjska";"16";"2011";3069;1728;1341
"904";"Savinjska";"16";"2012";2858;1491;1367
"905";"Savinjska";"16";"2013";2945;1619;1326
"906";"Savinjska";"16";"2014";2954;1623;1331
"907";"Savinjska";"16";"2015";2910;1606;1304
"908";"Savinjska";"16";"2016";2878;1485;1393
"909";"Savinjska";"16";"2017 (začasni podatki)";2990;1567;1423
"910";"Savinjska";"17";"2009";3349;1706;1643
"911";"Savinjska";"17";"2010";3300;1680;1620
"912";"Savinjska";"17";"2011";3096;1512;1584
"913";"Savinjska";"17";"2012";3012;1419;1593
"914";"Savinjska";"17";"2013";3022;1473;1549
"915";"Savinjska";"17";"2014";2921;1429;1492
"916";"Savinjska";"17";"2015";2849;1453;1396
"917";"Savinjska";"17";"2016";2950;1434;1516
"918";"Savinjska";"17";"2017 (začasni podatki)";2985;1472;1513
"919";"Savinjska";"18";"2009";3272;1573;1699
"920";"Savinjska";"18";"2010";3109;1534;1575
"921";"Savinjska";"18";"2011";3123;1544;1579
"922";"Savinjska";"18";"2012";2909;1466;1443
"923";"Savinjska";"18";"2013";2846;1526;1320
"924";"Savinjska";"18";"2014";2852;1531;1321
"925";"Savinjska";"18";"2015";2807;1492;1315
"926";"Savinjska";"18";"2016";2706;1469;1237
"927";"Savinjska";"18";"2017 (začasni podatki)";2851;1610;1241
"928";"Savinjska";"19";"2009";2847;1676;1171
"929";"Savinjska";"19";"2010";2689;1591;1098
"930";"Savinjska";"19";"2011";2720;1658;1062
"931";"Savinjska";"19";"2012";2736;1723;1013
"932";"Savinjska";"19";"2013";2614;1608;1006
"933";"Savinjska";"19";"2014";2688;1697;991
"934";"Savinjska";"19";"2015";2497;1558;939
"935";"Savinjska";"19";"2016";2396;1486;910
"936";"Savinjska";"19";"2017 (začasni podatki)";2533;1603;930
"937";"Savinjska";"20";"2009";2144;1409;735
"938";"Savinjska";"20";"2010";2114;1388;726
"939";"Savinjska";"20";"2011";2074;1397;677
"940";"Savinjska";"20";"2012";2067;1387;680
"941";"Savinjska";"20";"2013";2033;1377;656
"942";"Savinjska";"20";"2014";2065;1428;637
"943";"Savinjska";"20";"2015";1895;1301;594
"944";"Savinjska";"20";"2016";1827;1227;600
"945";"Savinjska";"20";"2017 (začasni podatki)";1941;1301;640
"946";"Zasavska";"Razred neto - SKUPAJ";"2009";9150;4871;4279
"947";"Zasavska";"Razred neto - SKUPAJ";"2010";8646;4521;4125
"948";"Zasavska";"Razred neto - SKUPAJ";"2011";8410;4362;4048
"949";"Zasavska";"Razred neto - SKUPAJ";"2012";7914;4067;3847
"950";"Zasavska";"Razred neto - SKUPAJ";"2013";7611;3858;3753
"951";"Zasavska";"Razred neto - SKUPAJ";"2014";7386;3693;3693
"952";"Zasavska";"Razred neto - SKUPAJ";"2015";9083;4555;4528
"953";"Zasavska";"Razred neto - SKUPAJ";"2016";8871;4373;4498
"954";"Zasavska";"Razred neto - SKUPAJ";"2017 (začasni podatki)";9061;4490;4571
"955";"Zasavska";"01";"2009";454;170;284
"956";"Zasavska";"01";"2010";462;182;280
"957";"Zasavska";"01";"2011";420;169;251
"958";"Zasavska";"01";"2012";502;177;325
"959";"Zasavska";"01";"2013";413;169;244
"960";"Zasavska";"01";"2014";439;158;281
"961";"Zasavska";"01";"2015";572;236;336
"962";"Zasavska";"01";"2016";494;203;291
"963";"Zasavska";"01";"2017 (začasni podatki)";507;220;287
"964";"Zasavska";"02";"2009";579;211;368
"965";"Zasavska";"02";"2010";541;195;346
"966";"Zasavska";"02";"2011";543;200;343
"967";"Zasavska";"02";"2012";452;174;278
"968";"Zasavska";"02";"2013";453;153;300
"969";"Zasavska";"02";"2014";442;143;299
"970";"Zasavska";"02";"2015";529;201;328
"971";"Zasavska";"02";"2016";524;193;331
"972";"Zasavska";"02";"2017 (začasni podatki)";613;216;397
"973";"Zasavska";"03";"2009";561;199;362
"974";"Zasavska";"03";"2010";490;207;283
"975";"Zasavska";"03";"2011";419;194;225
"976";"Zasavska";"03";"2012";447;184;263
"977";"Zasavska";"03";"2013";348;132;216
"978";"Zasavska";"03";"2014";388;157;231
"979";"Zasavska";"03";"2015";619;282;337
"980";"Zasavska";"03";"2016";599;253;346
"981";"Zasavska";"03";"2017 (začasni podatki)";591;272;319
"982";"Zasavska";"04";"2009";501;208;293
"983";"Zasavska";"04";"2010";469;213;256
"984";"Zasavska";"04";"2011";422;185;237
"985";"Zasavska";"04";"2012";431;205;226
"986";"Zasavska";"04";"2013";415;168;247
"987";"Zasavska";"04";"2014";416;170;246
"988";"Zasavska";"04";"2015";610;262;348
"989";"Zasavska";"04";"2016";644;278;366
"990";"Zasavska";"04";"2017 (začasni podatki)";614;265;349
"991";"Zasavska";"05";"2009";504;263;241
"992";"Zasavska";"05";"2010";521;239;282
"993";"Zasavska";"05";"2011";433;202;231
"994";"Zasavska";"05";"2012";402;187;215
"995";"Zasavska";"05";"2013";443;189;254
"996";"Zasavska";"05";"2014";482;223;259
"997";"Zasavska";"05";"2015";564;255;309
"998";"Zasavska";"05";"2016";561;268;293
"999";"Zasavska";"05";"2017 (začasni podatki)";589;261;328
"1000";"Zasavska";"06";"2009";466;267;199
"1001";"Zasavska";"06";"2010";471;236;235
"1002";"Zasavska";"06";"2011";440;194;246
"1003";"Zasavska";"06";"2012";465;225;240
"1004";"Zasavska";"06";"2013";462;230;232
"1005";"Zasavska";"06";"2014";416;203;213
"1006";"Zasavska";"06";"2015";536;246;290
"1007";"Zasavska";"06";"2016";542;257;285
"1008";"Zasavska";"06";"2017 (začasni podatki)";576;269;307
"1009";"Zasavska";"07";"2009";481;306;175
"1010";"Zasavska";"07";"2010";422;241;181
"1011";"Zasavska";"07";"2011";463;240;223
"1012";"Zasavska";"07";"2012";463;249;214
"1013";"Zasavska";"07";"2013";384;206;178
"1014";"Zasavska";"07";"2014";411;246;165
"1015";"Zasavska";"07";"2015";546;321;225
"1016";"Zasavska";"07";"2016";510;297;213
"1017";"Zasavska";"07";"2017 (začasni podatki)";506;304;202
"1018";"Zasavska";"08";"2009";516;335;181
"1019";"Zasavska";"08";"2010";437;271;166
"1020";"Zasavska";"08";"2011";438;265;173
"1021";"Zasavska";"08";"2012";424;270;154
"1022";"Zasavska";"08";"2013";444;271;173
"1023";"Zasavska";"08";"2014";425;272;153
"1024";"Zasavska";"08";"2015";480;321;159
"1025";"Zasavska";"08";"2016";510;351;159
"1026";"Zasavska";"08";"2017 (začasni podatki)";466;313;153
"1027";"Zasavska";"09";"2009";419;286;133
"1028";"Zasavska";"09";"2010";359;249;110
"1029";"Zasavska";"09";"2011";415;281;134
"1030";"Zasavska";"09";"2012";399;269;130
"1031";"Zasavska";"09";"2013";393;268;125
"1032";"Zasavska";"09";"2014";414;280;134
"1033";"Zasavska";"09";"2015";460;314;146
"1034";"Zasavska";"09";"2016";420;272;148
"1035";"Zasavska";"09";"2017 (začasni podatki)";450;301;149
"1036";"Zasavska";"10";"2009";416;277;139
"1037";"Zasavska";"10";"2010";424;273;151
"1038";"Zasavska";"10";"2011";418;252;166
"1039";"Zasavska";"10";"2012";361;226;135
"1040";"Zasavska";"10";"2013";364;212;152
"1041";"Zasavska";"10";"2014";363;214;149
"1042";"Zasavska";"10";"2015";492;299;193
"1043";"Zasavska";"10";"2016";481;288;193
"1044";"Zasavska";"10";"2017 (začasni podatki)";473;265;208
"1045";"Zasavska";"11";"2009";435;276;159
"1046";"Zasavska";"11";"2010";401;235;166
"1047";"Zasavska";"11";"2011";400;228;172
"1048";"Zasavska";"11";"2012";375;213;162
"1049";"Zasavska";"11";"2013";402;214;188
"1050";"Zasavska";"11";"2014";369;196;173
"1051";"Zasavska";"11";"2015";473;252;221
"1052";"Zasavska";"11";"2016";435;230;205
"1053";"Zasavska";"11";"2017 (začasni podatki)";457;240;217
"1054";"Zasavska";"12";"2009";402;232;170
"1055";"Zasavska";"12";"2010";364;207;157
"1056";"Zasavska";"12";"2011";393;229;164
"1057";"Zasavska";"12";"2012";383;198;185
"1058";"Zasavska";"12";"2013";373;229;144
"1059";"Zasavska";"12";"2014";363;207;156
"1060";"Zasavska";"12";"2015";373;206;167
"1061";"Zasavska";"12";"2016";381;188;193
"1062";"Zasavska";"12";"2017 (začasni podatki)";380;205;175
"1063";"Zasavska";"13";"2009";411;229;182
"1064";"Zasavska";"13";"2010";422;235;187
"1065";"Zasavska";"13";"2011";405;225;180
"1066";"Zasavska";"13";"2012";346;194;152
"1067";"Zasavska";"13";"2013";353;198;155
"1068";"Zasavska";"13";"2014";319;173;146
"1069";"Zasavska";"13";"2015";373;211;162
"1070";"Zasavska";"13";"2016";347;191;156
"1071";"Zasavska";"13";"2017 (začasni podatki)";364;205;159
"1072";"Zasavska";"14";"2009";445;265;180
"1073";"Zasavska";"14";"2010";453;242;211
"1074";"Zasavska";"14";"2011";418;235;183
"1075";"Zasavska";"14";"2012";362;196;166
"1076";"Zasavska";"14";"2013";385;215;170
"1077";"Zasavska";"14";"2014";325;174;151
"1078";"Zasavska";"14";"2015";421;208;213
"1079";"Zasavska";"14";"2016";361;179;182
"1080";"Zasavska";"14";"2017 (začasni podatki)";398;187;211
"1081";"Zasavska";"15";"2009";484;265;219
"1082";"Zasavska";"15";"2010";458;270;188
"1083";"Zasavska";"15";"2011";433;234;199
"1084";"Zasavska";"15";"2012";387;198;189
"1085";"Zasavska";"15";"2013";353;186;167
"1086";"Zasavska";"15";"2014";364;170;194
"1087";"Zasavska";"15";"2015";396;192;204
"1088";"Zasavska";"15";"2016";401;181;220
"1089";"Zasavska";"15";"2017 (začasni podatki)";401;184;217
"1090";"Zasavska";"16";"2009";467;251;216
"1091";"Zasavska";"16";"2010";448;236;212
"1092";"Zasavska";"16";"2011";447;224;223
"1093";"Zasavska";"16";"2012";365;199;166
"1094";"Zasavska";"16";"2013";343;174;169
"1095";"Zasavska";"16";"2014";336;168;168
"1096";"Zasavska";"16";"2015";379;175;204
"1097";"Zasavska";"16";"2016";425;184;241
"1098";"Zasavska";"16";"2017 (začasni podatki)";405;194;211
"1099";"Zasavska";"17";"2009";450;226;224
"1100";"Zasavska";"17";"2010";409;215;194
"1101";"Zasavska";"17";"2011";438;224;214
"1102";"Zasavska";"17";"2012";389;186;203
"1103";"Zasavska";"17";"2013";376;175;201
"1104";"Zasavska";"17";"2014";308;139;169
"1105";"Zasavska";"17";"2015";361;141;220
"1106";"Zasavska";"17";"2016";397;152;245
"1107";"Zasavska";"17";"2017 (začasni podatki)";417;153;264
"1108";"Zasavska";"18";"2009";478;226;252
"1109";"Zasavska";"18";"2010";425;184;241
"1110";"Zasavska";"18";"2011";413;206;207
"1111";"Zasavska";"18";"2012";365;169;196
"1112";"Zasavska";"18";"2013";353;145;208
"1113";"Zasavska";"18";"2014";313;129;184
"1114";"Zasavska";"18";"2015";368;146;222
"1115";"Zasavska";"18";"2016";331;126;205
"1116";"Zasavska";"18";"2017 (začasni podatki)";316;129;187
"1117";"Zasavska";"19";"2009";343;168;175
"1118";"Zasavska";"19";"2010";350;193;157
"1119";"Zasavska";"19";"2011";343;179;164
"1120";"Zasavska";"19";"2012";319;181;138
"1121";"Zasavska";"19";"2013";287;164;123
"1122";"Zasavska";"19";"2014";245;125;120
"1123";"Zasavska";"19";"2015";271;135;136
"1124";"Zasavska";"19";"2016";248;130;118
"1125";"Zasavska";"19";"2017 (začasni podatki)";273;148;125
"1126";"Zasavska";"20";"2009";338;211;127
"1127";"Zasavska";"20";"2010";320;198;122
"1128";"Zasavska";"20";"2011";309;196;113
"1129";"Zasavska";"20";"2012";277;167;110
"1130";"Zasavska";"20";"2013";267;160;107
"1131";"Zasavska";"20";"2014";248;146;102
"1132";"Zasavska";"20";"2015";260;152;108
"1133";"Zasavska";"20";"2016";260;152;108
"1134";"Zasavska";"20";"2017 (začasni podatki)";265;159;106
"1135";"Posavska";"Razred neto - SKUPAJ";"2009";16298;9105;7193
"1136";"Posavska";"Razred neto - SKUPAJ";"2010";15299;8509;6790
"1137";"Posavska";"Razred neto - SKUPAJ";"2011";14479;7859;6620
"1138";"Posavska";"Razred neto - SKUPAJ";"2012";14042;7494;6548
"1139";"Posavska";"Razred neto - SKUPAJ";"2013";13444;7048;6396
"1140";"Posavska";"Razred neto - SKUPAJ";"2014";14116;7570;6546
"1141";"Posavska";"Razred neto - SKUPAJ";"2015";14533;7807;6726
"1142";"Posavska";"Razred neto - SKUPAJ";"2016";15005;8093;6912
"1143";"Posavska";"Razred neto - SKUPAJ";"2017 (začasni podatki)";15435;8314;7121
"1144";"Posavska";"01";"2009";1348;847;501
"1145";"Posavska";"01";"2010";909;502;407
"1146";"Posavska";"01";"2011";742;329;413
"1147";"Posavska";"01";"2012";776;341;435
"1148";"Posavska";"01";"2013";747;307;440
"1149";"Posavska";"01";"2014";763;329;434
"1150";"Posavska";"01";"2015";827;337;490
"1151";"Posavska";"01";"2016";832;359;473
"1152";"Posavska";"01";"2017 (začasni podatki)";897;411;486
"1153";"Posavska";"02";"2009";1142;482;660
"1154";"Posavska";"02";"2010";1127;643;484
"1155";"Posavska";"02";"2011";884;385;499
"1156";"Posavska";"02";"2012";917;384;533
"1157";"Posavska";"02";"2013";853;353;500
"1158";"Posavska";"02";"2014";831;334;497
"1159";"Posavska";"02";"2015";941;370;571
"1160";"Posavska";"02";"2016";907;352;555
"1161";"Posavska";"02";"2017 (začasni podatki)";952;380;572
"1162";"Posavska";"03";"2009";955;435;520
"1163";"Posavska";"03";"2010";1000;498;502
"1164";"Posavska";"03";"2011";1100;592;508
"1165";"Posavska";"03";"2012";1001;479;522
"1166";"Posavska";"03";"2013";1020;494;526
"1167";"Posavska";"03";"2014";1100;526;574
"1168";"Posavska";"03";"2015";1021;497;524
"1169";"Posavska";"03";"2016";992;435;557
"1170";"Posavska";"03";"2017 (začasni podatki)";972;429;543
"1171";"Posavska";"04";"2009";916;452;464
"1172";"Posavska";"04";"2010";901;430;471
"1173";"Posavska";"04";"2011";940;449;491
"1174";"Posavska";"04";"2012";913;447;466
"1175";"Posavska";"04";"2013";908;427;481
"1176";"Posavska";"04";"2014";963;463;500
"1177";"Posavska";"04";"2015";971;445;526
"1178";"Posavska";"04";"2016";1006;467;539
"1179";"Posavska";"04";"2017 (začasni podatki)";947;415;532
"1180";"Posavska";"05";"2009";855;449;406
"1181";"Posavska";"05";"2010";924;501;423
"1182";"Posavska";"05";"2011";873;449;424
"1183";"Posavska";"05";"2012";788;365;423
"1184";"Posavska";"05";"2013";814;407;407
"1185";"Posavska";"05";"2014";835;424;411
"1186";"Posavska";"05";"2015";857;462;395
"1187";"Posavska";"05";"2016";883;483;400
"1188";"Posavska";"05";"2017 (začasni podatki)";884;462;422
"1189";"Posavska";"06";"2009";947;549;398
"1190";"Posavska";"06";"2010";900;486;414
"1191";"Posavska";"06";"2011";771;405;366
"1192";"Posavska";"06";"2012";752;399;353
"1193";"Posavska";"06";"2013";702;391;311
"1194";"Posavska";"06";"2014";791;444;347
"1195";"Posavska";"06";"2015";779;446;333
"1196";"Posavska";"06";"2016";851;457;394
"1197";"Posavska";"06";"2017 (začasni podatki)";890;510;380
"1198";"Posavska";"07";"2009";834;494;340
"1199";"Posavska";"07";"2010";744;412;332
"1200";"Posavska";"07";"2011";738;414;324
"1201";"Posavska";"07";"2012";746;422;324
"1202";"Posavska";"07";"2013";722;431;291
"1203";"Posavska";"07";"2014";722;468;254
"1204";"Posavska";"07";"2015";795;494;301
"1205";"Posavska";"07";"2016";832;524;308
"1206";"Posavska";"07";"2017 (začasni podatki)";862;487;375
"1207";"Posavska";"08";"2009";754;466;288
"1208";"Posavska";"08";"2010";829;503;326
"1209";"Posavska";"08";"2011";803;515;288
"1210";"Posavska";"08";"2012";719;454;265
"1211";"Posavska";"08";"2013";691;425;266
"1212";"Posavska";"08";"2014";737;444;293
"1213";"Posavska";"08";"2015";770;476;294
"1214";"Posavska";"08";"2016";813;518;295
"1215";"Posavska";"08";"2017 (začasni podatki)";835;525;310
"1216";"Posavska";"09";"2009";889;550;339
"1217";"Posavska";"09";"2010";765;471;294
"1218";"Posavska";"09";"2011";662;398;264
"1219";"Posavska";"09";"2012";723;452;271
"1220";"Posavska";"09";"2013";730;442;288
"1221";"Posavska";"09";"2014";713;430;283
"1222";"Posavska";"09";"2015";738;443;295
"1223";"Posavska";"09";"2016";725;450;275
"1224";"Posavska";"09";"2017 (začasni podatki)";794;491;303
"1225";"Posavska";"10";"2009";767;509;258
"1226";"Posavska";"10";"2010";760;463;297
"1227";"Posavska";"10";"2011";762;441;321
"1228";"Posavska";"10";"2012";738;429;309
"1229";"Posavska";"10";"2013";652;390;262
"1230";"Posavska";"10";"2014";685;403;282
"1231";"Posavska";"10";"2015";701;413;288
"1232";"Posavska";"10";"2016";718;420;298
"1233";"Posavska";"10";"2017 (začasni podatki)";763;461;302
"1234";"Posavska";"11";"2009";771;449;322
"1235";"Posavska";"11";"2010";784;457;327
"1236";"Posavska";"11";"2011";676;388;288
"1237";"Posavska";"11";"2012";692;415;277
"1238";"Posavska";"11";"2013";607;329;278
"1239";"Posavska";"11";"2014";663;364;299
"1240";"Posavska";"11";"2015";710;411;299
"1241";"Posavska";"11";"2016";678;393;285
"1242";"Posavska";"11";"2017 (začasni podatki)";692;412;280
"1243";"Posavska";"12";"2009";846;481;365
"1244";"Posavska";"12";"2010";702;401;301
"1245";"Posavska";"12";"2011";649;376;273
"1246";"Posavska";"12";"2012";583;320;263
"1247";"Posavska";"12";"2013";551;297;254
"1248";"Posavska";"12";"2014";618;352;266
"1249";"Posavska";"12";"2015";680;376;304
"1250";"Posavska";"12";"2016";635;355;280
"1251";"Posavska";"12";"2017 (začasni podatki)";681;401;280
"1252";"Posavska";"13";"2009";660;384;276
"1253";"Posavska";"13";"2010";605;354;251
"1254";"Posavska";"13";"2011";630;371;259
"1255";"Posavska";"13";"2012";607;323;284
"1256";"Posavska";"13";"2013";571;287;284
"1257";"Posavska";"13";"2014";627;332;295
"1258";"Posavska";"13";"2015";585;331;254
"1259";"Posavska";"13";"2016";644;362;282
"1260";"Posavska";"13";"2017 (začasni podatki)";674;377;297
"1261";"Posavska";"14";"2009";622;346;276
"1262";"Posavska";"14";"2010";634;362;272
"1263";"Posavska";"14";"2011";590;323;267
"1264";"Posavska";"14";"2012";538;305;233
"1265";"Posavska";"14";"2013";500;272;228
"1266";"Posavska";"14";"2014";577;329;248
"1267";"Posavska";"14";"2015";578;323;255
"1268";"Posavska";"14";"2016";650;356;294
"1269";"Posavska";"14";"2017 (začasni podatki)";643;346;297
"1270";"Posavska";"15";"2009";703;388;315
"1271";"Posavska";"15";"2010";670;369;301
"1272";"Posavska";"15";"2011";600;347;253
"1273";"Posavska";"15";"2012";548;307;241
"1274";"Posavska";"15";"2013";517;248;269
"1275";"Posavska";"15";"2014";525;276;249
"1276";"Posavska";"15";"2015";568;306;262
"1277";"Posavska";"15";"2016";599;315;284
"1278";"Posavska";"15";"2017 (začasni podatki)";641;331;310
"1279";"Posavska";"16";"2009";674;390;284
"1280";"Posavska";"16";"2010";570;330;240
"1281";"Posavska";"16";"2011";627;369;258
"1282";"Posavska";"16";"2012";607;347;260
"1283";"Posavska";"16";"2013";553;295;258
"1284";"Posavska";"16";"2014";593;306;287
"1285";"Posavska";"16";"2015";596;310;286
"1286";"Posavska";"16";"2016";667;360;307
"1287";"Posavska";"16";"2017 (začasni podatki)";710;369;341
"1288";"Posavska";"17";"2009";668;336;332
"1289";"Posavska";"17";"2010";668;325;343
"1290";"Posavska";"17";"2011";649;310;339
"1291";"Posavska";"17";"2012";608;263;345
"1292";"Posavska";"17";"2013";557;227;330
"1293";"Posavska";"17";"2014";571;259;312
"1294";"Posavska";"17";"2015";592;262;330
"1295";"Posavska";"17";"2016";705;317;388
"1296";"Posavska";"17";"2017 (začasni podatki)";724;333;391
"1297";"Posavska";"18";"2009";725;324;401
"1298";"Posavska";"18";"2010";705;316;389
"1299";"Posavska";"18";"2011";641;284;357
"1300";"Posavska";"18";"2012";624;301;323
"1301";"Posavska";"18";"2013";648;320;328
"1302";"Posavska";"18";"2014";630;300;330
"1303";"Posavska";"18";"2015";634;308;326
"1304";"Posavska";"18";"2016";636;344;292
"1305";"Posavska";"18";"2017 (začasni podatki)";651;375;276
"1306";"Posavska";"19";"2009";617;351;266
"1307";"Posavska";"19";"2010";551;298;253
"1308";"Posavska";"19";"2011";590;319;271
"1309";"Posavska";"19";"2012";592;328;264
"1310";"Posavska";"19";"2013";580;325;255
"1311";"Posavska";"19";"2014";603;367;236
"1312";"Posavska";"19";"2015";643;396;247
"1313";"Posavska";"19";"2016";640;393;247
"1314";"Posavska";"19";"2017 (začasni podatki)";623;377;246
"1315";"Posavska";"20";"2009";605;423;182
"1316";"Posavska";"20";"2010";551;388;163
"1317";"Posavska";"20";"2011";552;395;157
"1318";"Posavska";"20";"2012";570;413;157
"1319";"Posavska";"20";"2013";521;381;140
"1320";"Posavska";"20";"2014";569;420;149
"1321";"Posavska";"20";"2015";547;401;146
"1322";"Posavska";"20";"2016";592;433;159
"1323";"Posavska";"20";"2017 (začasni podatki)";600;422;178
"1324";"Jugovzhodna Slovenija";"Razred neto - SKUPAJ";"2009";39268;22419;16849
"1325";"Jugovzhodna Slovenija";"Razred neto - SKUPAJ";"2010";36482;20851;15631
"1326";"Jugovzhodna Slovenija";"Razred neto - SKUPAJ";"2011";35398;20064;15334
"1327";"Jugovzhodna Slovenija";"Razred neto - SKUPAJ";"2012";34659;19407;15252
"1328";"Jugovzhodna Slovenija";"Razred neto - SKUPAJ";"2013";34550;19075;15475
"1329";"Jugovzhodna Slovenija";"Razred neto - SKUPAJ";"2014";34807;19320;15487
"1330";"Jugovzhodna Slovenija";"Razred neto - SKUPAJ";"2015";35066;19449;15617
"1331";"Jugovzhodna Slovenija";"Razred neto - SKUPAJ";"2016";36125;20217;15908
"1332";"Jugovzhodna Slovenija";"Razred neto - SKUPAJ";"2017 (začasni podatki)";37277;20811;16466
"1333";"Jugovzhodna Slovenija";"01";"2009";1860;1077;783
"1334";"Jugovzhodna Slovenija";"01";"2010";1776;887;889
"1335";"Jugovzhodna Slovenija";"01";"2011";1592;801;791
"1336";"Jugovzhodna Slovenija";"01";"2012";1568;753;815
"1337";"Jugovzhodna Slovenija";"01";"2013";1618;752;866
"1338";"Jugovzhodna Slovenija";"01";"2014";1371;624;747
"1339";"Jugovzhodna Slovenija";"01";"2015";1606;710;896
"1340";"Jugovzhodna Slovenija";"01";"2016";1557;729;828
"1341";"Jugovzhodna Slovenija";"01";"2017 (začasni podatki)";1627;802;825
"1342";"Jugovzhodna Slovenija";"02";"2009";1976;946;1030
"1343";"Jugovzhodna Slovenija";"02";"2010";1550;811;739
"1344";"Jugovzhodna Slovenija";"02";"2011";1572;784;788
"1345";"Jugovzhodna Slovenija";"02";"2012";1493;728;765
"1346";"Jugovzhodna Slovenija";"02";"2013";1635;691;944
"1347";"Jugovzhodna Slovenija";"02";"2014";1500;668;832
"1348";"Jugovzhodna Slovenija";"02";"2015";1567;697;870
"1349";"Jugovzhodna Slovenija";"02";"2016";1593;716;877
"1350";"Jugovzhodna Slovenija";"02";"2017 (začasni podatki)";1729;845;884
"1351";"Jugovzhodna Slovenija";"03";"2009";2181;1105;1076
"1352";"Jugovzhodna Slovenija";"03";"2010";1719;899;820
"1353";"Jugovzhodna Slovenija";"03";"2011";1604;839;765
"1354";"Jugovzhodna Slovenija";"03";"2012";1806;897;909
"1355";"Jugovzhodna Slovenija";"03";"2013";1691;879;812
"1356";"Jugovzhodna Slovenija";"03";"2014";1961;997;964
"1357";"Jugovzhodna Slovenija";"03";"2015";1766;931;835
"1358";"Jugovzhodna Slovenija";"03";"2016";1902;981;921
"1359";"Jugovzhodna Slovenija";"03";"2017 (začasni podatki)";1872;910;962
"1360";"Jugovzhodna Slovenija";"04";"2009";2155;1006;1149
"1361";"Jugovzhodna Slovenija";"04";"2010";1799;913;886
"1362";"Jugovzhodna Slovenija";"04";"2011";1733;917;816
"1363";"Jugovzhodna Slovenija";"04";"2012";1795;975;820
"1364";"Jugovzhodna Slovenija";"04";"2013";1799;898;901
"1365";"Jugovzhodna Slovenija";"04";"2014";1690;838;852
"1366";"Jugovzhodna Slovenija";"04";"2015";1820;924;896
"1367";"Jugovzhodna Slovenija";"04";"2016";1801;952;849
"1368";"Jugovzhodna Slovenija";"04";"2017 (začasni podatki)";1957;941;1016
"1369";"Jugovzhodna Slovenija";"05";"2009";2057;1137;920
"1370";"Jugovzhodna Slovenija";"05";"2010";1869;1011;858
"1371";"Jugovzhodna Slovenija";"05";"2011";1725;978;747
"1372";"Jugovzhodna Slovenija";"05";"2012";1766;934;832
"1373";"Jugovzhodna Slovenija";"05";"2013";1921;1040;881
"1374";"Jugovzhodna Slovenija";"05";"2014";1934;1057;877
"1375";"Jugovzhodna Slovenija";"05";"2015";1822;1022;800
"1376";"Jugovzhodna Slovenija";"05";"2016";1809;999;810
"1377";"Jugovzhodna Slovenija";"05";"2017 (začasni podatki)";1910;1002;908
"1378";"Jugovzhodna Slovenija";"06";"2009";2192;1352;840
"1379";"Jugovzhodna Slovenija";"06";"2010";2046;1201;845
"1380";"Jugovzhodna Slovenija";"06";"2011";1876;1106;770
"1381";"Jugovzhodna Slovenija";"06";"2012";1803;1088;715
"1382";"Jugovzhodna Slovenija";"06";"2013";1879;1145;734
"1383";"Jugovzhodna Slovenija";"06";"2014";1857;1077;780
"1384";"Jugovzhodna Slovenija";"06";"2015";1743;992;751
"1385";"Jugovzhodna Slovenija";"06";"2016";1928;1123;805
"1386";"Jugovzhodna Slovenija";"06";"2017 (začasni podatki)";1902;1099;803
"1387";"Jugovzhodna Slovenija";"07";"2009";2197;1421;776
"1388";"Jugovzhodna Slovenija";"07";"2010";1982;1254;728
"1389";"Jugovzhodna Slovenija";"07";"2011";1965;1237;728
"1390";"Jugovzhodna Slovenija";"07";"2012";1945;1249;696
"1391";"Jugovzhodna Slovenija";"07";"2013";1851;1166;685
"1392";"Jugovzhodna Slovenija";"07";"2014";1823;1179;644
"1393";"Jugovzhodna Slovenija";"07";"2015";1731;1048;683
"1394";"Jugovzhodna Slovenija";"07";"2016";1849;1141;708
"1395";"Jugovzhodna Slovenija";"07";"2017 (začasni podatki)";1874;1123;751
"1396";"Jugovzhodna Slovenija";"08";"2009";2085;1384;701
"1397";"Jugovzhodna Slovenija";"08";"2010";1964;1276;688
"1398";"Jugovzhodna Slovenija";"08";"2011";1961;1232;729
"1399";"Jugovzhodna Slovenija";"08";"2012";1842;1139;703
"1400";"Jugovzhodna Slovenija";"08";"2013";1832;1193;639
"1401";"Jugovzhodna Slovenija";"08";"2014";1807;1142;665
"1402";"Jugovzhodna Slovenija";"08";"2015";1841;1159;682
"1403";"Jugovzhodna Slovenija";"08";"2016";1816;1135;681
"1404";"Jugovzhodna Slovenija";"08";"2017 (začasni podatki)";1944;1217;727
"1405";"Jugovzhodna Slovenija";"09";"2009";2076;1384;692
"1406";"Jugovzhodna Slovenija";"09";"2010";1878;1249;629
"1407";"Jugovzhodna Slovenija";"09";"2011";1902;1237;665
"1408";"Jugovzhodna Slovenija";"09";"2012";1823;1165;658
"1409";"Jugovzhodna Slovenija";"09";"2013";1802;1136;666
"1410";"Jugovzhodna Slovenija";"09";"2014";1829;1133;696
"1411";"Jugovzhodna Slovenija";"09";"2015";1748;1064;684
"1412";"Jugovzhodna Slovenija";"09";"2016";1877;1155;722
"1413";"Jugovzhodna Slovenija";"09";"2017 (začasni podatki)";1957;1227;730
"1414";"Jugovzhodna Slovenija";"10";"2009";2120;1366;754
"1415";"Jugovzhodna Slovenija";"10";"2010";2041;1290;751
"1416";"Jugovzhodna Slovenija";"10";"2011";1941;1205;736
"1417";"Jugovzhodna Slovenija";"10";"2012";1883;1160;723
"1418";"Jugovzhodna Slovenija";"10";"2013";1890;1191;699
"1419";"Jugovzhodna Slovenija";"10";"2014";1846;1133;713
"1420";"Jugovzhodna Slovenija";"10";"2015";1761;1073;688
"1421";"Jugovzhodna Slovenija";"10";"2016";1839;1089;750
"1422";"Jugovzhodna Slovenija";"10";"2017 (začasni podatki)";1905;1138;767
"1423";"Jugovzhodna Slovenija";"11";"2009";2149;1351;798
"1424";"Jugovzhodna Slovenija";"11";"2010";1976;1233;743
"1425";"Jugovzhodna Slovenija";"11";"2011";1871;1145;726
"1426";"Jugovzhodna Slovenija";"11";"2012";1813;1124;689
"1427";"Jugovzhodna Slovenija";"11";"2013";1747;1064;683
"1428";"Jugovzhodna Slovenija";"11";"2014";1834;1129;705
"1429";"Jugovzhodna Slovenija";"11";"2015";1921;1148;773
"1430";"Jugovzhodna Slovenija";"11";"2016";1893;1148;745
"1431";"Jugovzhodna Slovenija";"11";"2017 (začasni podatki)";1961;1124;837
"1432";"Jugovzhodna Slovenija";"12";"2009";2104;1296;808
"1433";"Jugovzhodna Slovenija";"12";"2010";1980;1258;722
"1434";"Jugovzhodna Slovenija";"12";"2011";1956;1238;718
"1435";"Jugovzhodna Slovenija";"12";"2012";1839;1147;692
"1436";"Jugovzhodna Slovenija";"12";"2013";1791;1079;712
"1437";"Jugovzhodna Slovenija";"12";"2014";1749;1051;698
"1438";"Jugovzhodna Slovenija";"12";"2015";1808;1074;734
"1439";"Jugovzhodna Slovenija";"12";"2016";1914;1154;760
"1440";"Jugovzhodna Slovenija";"12";"2017 (začasni podatki)";1923;1148;775
"1441";"Jugovzhodna Slovenija";"13";"2009";1937;1164;773
"1442";"Jugovzhodna Slovenija";"13";"2010";1902;1147;755
"1443";"Jugovzhodna Slovenija";"13";"2011";1911;1161;750
"1444";"Jugovzhodna Slovenija";"13";"2012";1767;1027;740
"1445";"Jugovzhodna Slovenija";"13";"2013";1646;945;701
"1446";"Jugovzhodna Slovenija";"13";"2014";1764;1048;716
"1447";"Jugovzhodna Slovenija";"13";"2015";1883;1160;723
"1448";"Jugovzhodna Slovenija";"13";"2016";1925;1176;749
"1449";"Jugovzhodna Slovenija";"13";"2017 (začasni podatki)";2078;1324;754
"1450";"Jugovzhodna Slovenija";"14";"2009";1884;1078;806
"1451";"Jugovzhodna Slovenija";"14";"2010";1938;1157;781
"1452";"Jugovzhodna Slovenija";"14";"2011";1857;1104;753
"1453";"Jugovzhodna Slovenija";"14";"2012";1734;1012;722
"1454";"Jugovzhodna Slovenija";"14";"2013";1716;988;728
"1455";"Jugovzhodna Slovenija";"14";"2014";1747;1032;715
"1456";"Jugovzhodna Slovenija";"14";"2015";1826;1085;741
"1457";"Jugovzhodna Slovenija";"14";"2016";2024;1220;804
"1458";"Jugovzhodna Slovenija";"14";"2017 (začasni podatki)";2053;1231;822
"1459";"Jugovzhodna Slovenija";"15";"2009";2003;1130;873
"1460";"Jugovzhodna Slovenija";"15";"2010";1858;1074;784
"1461";"Jugovzhodna Slovenija";"15";"2011";1787;1022;765
"1462";"Jugovzhodna Slovenija";"15";"2012";1689;966;723
"1463";"Jugovzhodna Slovenija";"15";"2013";1740;955;785
"1464";"Jugovzhodna Slovenija";"15";"2014";1736;994;742
"1465";"Jugovzhodna Slovenija";"15";"2015";1844;1055;789
"1466";"Jugovzhodna Slovenija";"15";"2016";1838;1063;775
"1467";"Jugovzhodna Slovenija";"15";"2017 (začasni podatki)";1914;1138;776
"1468";"Jugovzhodna Slovenija";"16";"2009";1735;972;763
"1469";"Jugovzhodna Slovenija";"16";"2010";1739;966;773
"1470";"Jugovzhodna Slovenija";"16";"2011";1723;906;817
"1471";"Jugovzhodna Slovenija";"16";"2012";1687;898;789
"1472";"Jugovzhodna Slovenija";"16";"2013";1664;822;842
"1473";"Jugovzhodna Slovenija";"16";"2014";1808;939;869
"1474";"Jugovzhodna Slovenija";"16";"2015";1811;967;844
"1475";"Jugovzhodna Slovenija";"16";"2016";1926;1008;918
"1476";"Jugovzhodna Slovenija";"16";"2017 (začasni podatki)";1900;978;922
"1477";"Jugovzhodna Slovenija";"17";"2009";1737;824;913
"1478";"Jugovzhodna Slovenija";"17";"2010";1700;805;895
"1479";"Jugovzhodna Slovenija";"17";"2011";1710;815;895
"1480";"Jugovzhodna Slovenija";"17";"2012";1659;764;895
"1481";"Jugovzhodna Slovenija";"17";"2013";1630;752;878
"1482";"Jugovzhodna Slovenija";"17";"2014";1675;759;916
"1483";"Jugovzhodna Slovenija";"17";"2015";1706;827;879
"1484";"Jugovzhodna Slovenija";"17";"2016";1756;817;939
"1485";"Jugovzhodna Slovenija";"17";"2017 (začasni podatki)";1947;955;992
"1486";"Jugovzhodna Slovenija";"18";"2009";1805;776;1029
"1487";"Jugovzhodna Slovenija";"18";"2010";1757;766;991
"1488";"Jugovzhodna Slovenija";"18";"2011";1774;768;1006
"1489";"Jugovzhodna Slovenija";"18";"2012";1712;763;949
"1490";"Jugovzhodna Slovenija";"18";"2013";1658;728;930
"1491";"Jugovzhodna Slovenija";"18";"2014";1725;799;926
"1492";"Jugovzhodna Slovenija";"18";"2015";1745;796;949
"1493";"Jugovzhodna Slovenija";"18";"2016";1770;874;896
"1494";"Jugovzhodna Slovenija";"18";"2017 (začasni podatki)";1753;884;869
"1495";"Jugovzhodna Slovenija";"19";"2009";1597;845;752
"1496";"Jugovzhodna Slovenija";"19";"2010";1572;833;739
"1497";"Jugovzhodna Slovenija";"19";"2011";1468;741;727
"1498";"Jugovzhodna Slovenija";"19";"2012";1507;754;753
"1499";"Jugovzhodna Slovenija";"19";"2013";1491;778;713
"1500";"Jugovzhodna Slovenija";"19";"2014";1563;822;741
"1501";"Jugovzhodna Slovenija";"19";"2015";1540;827;713
"1502";"Jugovzhodna Slovenija";"19";"2016";1566;850;716
"1503";"Jugovzhodna Slovenija";"19";"2017 (začasni podatki)";1501;813;688
"1504";"Jugovzhodna Slovenija";"20";"2009";1418;805;613
"1505";"Jugovzhodna Slovenija";"20";"2010";1436;821;615
"1506";"Jugovzhodna Slovenija";"20";"2011";1470;828;642
"1507";"Jugovzhodna Slovenija";"20";"2012";1528;864;664
"1508";"Jugovzhodna Slovenija";"20";"2013";1549;873;676
"1509";"Jugovzhodna Slovenija";"20";"2014";1588;899;689
"1510";"Jugovzhodna Slovenija";"20";"2015";1577;890;687
"1511";"Jugovzhodna Slovenija";"20";"2016";1542;887;655
"1512";"Jugovzhodna Slovenija";"20";"2017 (začasni podatki)";1570;912;658
"1513";"Osrednjeslovenska";"Razred neto - SKUPAJ";"2009";200471;109130;91341
"1514";"Osrednjeslovenska";"Razred neto - SKUPAJ";"2010";194669;105220;89449
"1515";"Osrednjeslovenska";"Razred neto - SKUPAJ";"2011";187927;99893;88034
"1516";"Osrednjeslovenska";"Razred neto - SKUPAJ";"2012";186443;99752;86691
"1517";"Osrednjeslovenska";"Razred neto - SKUPAJ";"2013";187190;99760;87430
"1518";"Osrednjeslovenska";"Razred neto - SKUPAJ";"2014";191225;102583;88642
"1519";"Osrednjeslovenska";"Razred neto - SKUPAJ";"2015";187817;101129;86688
"1520";"Osrednjeslovenska";"Razred neto - SKUPAJ";"2016";189281;100581;88700
"1521";"Osrednjeslovenska";"Razred neto - SKUPAJ";"2017 (začasni podatki)";199099;106534;92565
"1522";"Osrednjeslovenska";"01";"2009";9405;5657;3748
"1523";"Osrednjeslovenska";"01";"2010";9174;4983;4191
"1524";"Osrednjeslovenska";"01";"2011";8238;4093;4145
"1525";"Osrednjeslovenska";"01";"2012";7985;4054;3931
"1526";"Osrednjeslovenska";"01";"2013";7823;3854;3969
"1527";"Osrednjeslovenska";"01";"2014";8449;4269;4180
"1528";"Osrednjeslovenska";"01";"2015";8856;4408;4448
"1529";"Osrednjeslovenska";"01";"2016";8785;4416;4369
"1530";"Osrednjeslovenska";"01";"2017 (začasni podatki)";9737;5124;4613
"1531";"Osrednjeslovenska";"02";"2009";8454;4730;3724
"1532";"Osrednjeslovenska";"02";"2010";8243;4598;3645
"1533";"Osrednjeslovenska";"02";"2011";7967;3958;4009
"1534";"Osrednjeslovenska";"02";"2012";7444;3683;3761
"1535";"Osrednjeslovenska";"02";"2013";7744;3593;4151
"1536";"Osrednjeslovenska";"02";"2014";7400;3551;3849
"1537";"Osrednjeslovenska";"02";"2015";7886;3829;4057
"1538";"Osrednjeslovenska";"02";"2016";7833;3827;4006
"1539";"Osrednjeslovenska";"02";"2017 (začasni podatki)";8735;4396;4339
"1540";"Osrednjeslovenska";"03";"2009";7325;3683;3642
"1541";"Osrednjeslovenska";"03";"2010";7600;3872;3728
"1542";"Osrednjeslovenska";"03";"2011";7377;3914;3463
"1543";"Osrednjeslovenska";"03";"2012";7695;3910;3785
"1544";"Osrednjeslovenska";"03";"2013";7711;4106;3605
"1545";"Osrednjeslovenska";"03";"2014";8753;4596;4157
"1546";"Osrednjeslovenska";"03";"2015";7749;4035;3714
"1547";"Osrednjeslovenska";"03";"2016";8183;4143;4040
"1548";"Osrednjeslovenska";"03";"2017 (začasni podatki)";8221;4116;4105
"1549";"Osrednjeslovenska";"04";"2009";7344;3665;3679
"1550";"Osrednjeslovenska";"04";"2010";7436;3886;3550
"1551";"Osrednjeslovenska";"04";"2011";7417;3869;3548
"1552";"Osrednjeslovenska";"04";"2012";7196;3650;3546
"1553";"Osrednjeslovenska";"04";"2013";7231;3547;3684
"1554";"Osrednjeslovenska";"04";"2014";7560;3651;3909
"1555";"Osrednjeslovenska";"04";"2015";7633;3777;3856
"1556";"Osrednjeslovenska";"04";"2016";7560;3704;3856
"1557";"Osrednjeslovenska";"04";"2017 (začasni podatki)";8237;3972;4265
"1558";"Osrednjeslovenska";"05";"2009";7760;4086;3674
"1559";"Osrednjeslovenska";"05";"2010";7538;3839;3699
"1560";"Osrednjeslovenska";"05";"2011";7369;3688;3681
"1561";"Osrednjeslovenska";"05";"2012";7528;3627;3901
"1562";"Osrednjeslovenska";"05";"2013";7817;3797;4020
"1563";"Osrednjeslovenska";"05";"2014";7841;3884;3957
"1564";"Osrednjeslovenska";"05";"2015";7711;3850;3861
"1565";"Osrednjeslovenska";"05";"2016";7882;3890;3992
"1566";"Osrednjeslovenska";"05";"2017 (začasni podatki)";8168;4009;4159
"1567";"Osrednjeslovenska";"06";"2009";7712;4241;3471
"1568";"Osrednjeslovenska";"06";"2010";7930;4108;3822
"1569";"Osrednjeslovenska";"06";"2011";7680;3866;3814
"1570";"Osrednjeslovenska";"06";"2012";7488;3889;3599
"1571";"Osrednjeslovenska";"06";"2013";7728;4044;3684
"1572";"Osrednjeslovenska";"06";"2014";7963;4287;3676
"1573";"Osrednjeslovenska";"06";"2015";7811;4146;3665
"1574";"Osrednjeslovenska";"06";"2016";7831;4118;3713
"1575";"Osrednjeslovenska";"06";"2017 (začasni podatki)";8177;4260;3917
"1576";"Osrednjeslovenska";"07";"2009";8017;4373;3644
"1577";"Osrednjeslovenska";"07";"2010";7960;4336;3624
"1578";"Osrednjeslovenska";"07";"2011";7806;4391;3415
"1579";"Osrednjeslovenska";"07";"2012";8066;4543;3523
"1580";"Osrednjeslovenska";"07";"2013";7873;4424;3449
"1581";"Osrednjeslovenska";"07";"2014";8023;4503;3520
"1582";"Osrednjeslovenska";"07";"2015";7863;4447;3416
"1583";"Osrednjeslovenska";"07";"2016";7597;4292;3305
"1584";"Osrednjeslovenska";"07";"2017 (začasni podatki)";7848;4464;3384
"1585";"Osrednjeslovenska";"08";"2009";8253;4658;3595
"1586";"Osrednjeslovenska";"08";"2010";8277;4748;3529
"1587";"Osrednjeslovenska";"08";"2011";8334;4775;3559
"1588";"Osrednjeslovenska";"08";"2012";7986;4591;3395
"1589";"Osrednjeslovenska";"08";"2013";7706;4424;3282
"1590";"Osrednjeslovenska";"08";"2014";8062;4685;3377
"1591";"Osrednjeslovenska";"08";"2015";7897;4646;3251
"1592";"Osrednjeslovenska";"08";"2016";7891;4541;3350
"1593";"Osrednjeslovenska";"08";"2017 (začasni podatki)";8330;4693;3637
"1594";"Osrednjeslovenska";"09";"2009";8503;4861;3642
"1595";"Osrednjeslovenska";"09";"2010";8342;4904;3438
"1596";"Osrednjeslovenska";"09";"2011";8173;4769;3404
"1597";"Osrednjeslovenska";"09";"2012";8031;4610;3421
"1598";"Osrednjeslovenska";"09";"2013";8130;4704;3426
"1599";"Osrednjeslovenska";"09";"2014";8367;4824;3543
"1600";"Osrednjeslovenska";"09";"2015";8058;4525;3533
"1601";"Osrednjeslovenska";"09";"2016";8177;4555;3622
"1602";"Osrednjeslovenska";"09";"2017 (začasni podatki)";8509;4764;3745
"1603";"Osrednjeslovenska";"10";"2009";8775;5088;3687
"1604";"Osrednjeslovenska";"10";"2010";8820;5061;3759
"1605";"Osrednjeslovenska";"10";"2011";8455;4824;3631
"1606";"Osrednjeslovenska";"10";"2012";8591;4807;3784
"1607";"Osrednjeslovenska";"10";"2013";8421;4657;3764
"1608";"Osrednjeslovenska";"10";"2014";8661;4763;3898
"1609";"Osrednjeslovenska";"10";"2015";8538;4742;3796
"1610";"Osrednjeslovenska";"10";"2016";8605;4786;3819
"1611";"Osrednjeslovenska";"10";"2017 (začasni podatki)";9113;5011;4102
"1612";"Osrednjeslovenska";"11";"2009";9438;5280;4158
"1613";"Osrednjeslovenska";"11";"2010";9003;4893;4110
"1614";"Osrednjeslovenska";"11";"2011";8804;4796;4008
"1615";"Osrednjeslovenska";"11";"2012";9032;5015;4017
"1616";"Osrednjeslovenska";"11";"2013";9016;4856;4160
"1617";"Osrednjeslovenska";"11";"2014";8979;4863;4116
"1618";"Osrednjeslovenska";"11";"2015";8781;4755;4026
"1619";"Osrednjeslovenska";"11";"2016";8997;4881;4116
"1620";"Osrednjeslovenska";"11";"2017 (začasni podatki)";9389;5140;4249
"1621";"Osrednjeslovenska";"12";"2009";9836;5299;4537
"1622";"Osrednjeslovenska";"12";"2010";9669;5193;4476
"1623";"Osrednjeslovenska";"12";"2011";9513;5075;4438
"1624";"Osrednjeslovenska";"12";"2012";9267;4846;4421
"1625";"Osrednjeslovenska";"12";"2013";9312;4985;4327
"1626";"Osrednjeslovenska";"12";"2014";9487;5182;4305
"1627";"Osrednjeslovenska";"12";"2015";9075;4892;4183
"1628";"Osrednjeslovenska";"12";"2016";9341;5010;4331
"1629";"Osrednjeslovenska";"12";"2017 (začasni podatki)";9630;5242;4388
"1630";"Osrednjeslovenska";"13";"2009";10687;5836;4851
"1631";"Osrednjeslovenska";"13";"2010";10272;5628;4644
"1632";"Osrednjeslovenska";"13";"2011";9663;5106;4557
"1633";"Osrednjeslovenska";"13";"2012";9855;5333;4522
"1634";"Osrednjeslovenska";"13";"2013";10012;5510;4502
"1635";"Osrednjeslovenska";"13";"2014";10048;5467;4581
"1636";"Osrednjeslovenska";"13";"2015";9537;5285;4252
"1637";"Osrednjeslovenska";"13";"2016";9437;5082;4355
"1638";"Osrednjeslovenska";"13";"2017 (začasni podatki)";9883;5472;4411
"1639";"Osrednjeslovenska";"14";"2009";11239;6098;5141
"1640";"Osrednjeslovenska";"14";"2010";10404;5637;4767
"1641";"Osrednjeslovenska";"14";"2011";10171;5467;4704
"1642";"Osrednjeslovenska";"14";"2012";10214;5705;4509
"1643";"Osrednjeslovenska";"14";"2013";10213;5622;4591
"1644";"Osrednjeslovenska";"14";"2014";10309;5747;4562
"1645";"Osrednjeslovenska";"14";"2015";9867;5471;4396
"1646";"Osrednjeslovenska";"14";"2016";10027;5507;4520
"1647";"Osrednjeslovenska";"14";"2017 (začasni podatki)";10357;5650;4707
"1648";"Osrednjeslovenska";"15";"2009";11650;6314;5336
"1649";"Osrednjeslovenska";"15";"2010";10952;5990;4962
"1650";"Osrednjeslovenska";"15";"2011";10548;5639;4909
"1651";"Osrednjeslovenska";"15";"2012";10459;5688;4771
"1652";"Osrednjeslovenska";"15";"2013";10626;5808;4818
"1653";"Osrednjeslovenska";"15";"2014";10538;5845;4693
"1654";"Osrednjeslovenska";"15";"2015";10431;5773;4658
"1655";"Osrednjeslovenska";"15";"2016";10402;5575;4827
"1656";"Osrednjeslovenska";"15";"2017 (začasni podatki)";11027;5967;5060
"1657";"Osrednjeslovenska";"16";"2009";11759;6339;5420
"1658";"Osrednjeslovenska";"16";"2010";11129;5878;5251
"1659";"Osrednjeslovenska";"16";"2011";10684;5440;5244
"1660";"Osrednjeslovenska";"16";"2012";10659;5564;5095
"1661";"Osrednjeslovenska";"16";"2013";10848;5540;5308
"1662";"Osrednjeslovenska";"16";"2014";10851;5605;5246
"1663";"Osrednjeslovenska";"16";"2015";10555;5367;5188
"1664";"Osrednjeslovenska";"16";"2016";10589;5130;5459
"1665";"Osrednjeslovenska";"16";"2017 (začasni podatki)";10947;5472;5475
"1666";"Osrednjeslovenska";"17";"2009";11760;5723;6037
"1667";"Osrednjeslovenska";"17";"2010";11030;5270;5760
"1668";"Osrednjeslovenska";"17";"2011";10659;4962;5697
"1669";"Osrednjeslovenska";"17";"2012";10617;5132;5485
"1670";"Osrednjeslovenska";"17";"2013";10668;5167;5501
"1671";"Osrednjeslovenska";"17";"2014";10922;5276;5646
"1672";"Osrednjeslovenska";"17";"2015";10629;5283;5346
"1673";"Osrednjeslovenska";"17";"2016";10353;4903;5450
"1674";"Osrednjeslovenska";"17";"2017 (začasni podatki)";10984;5313;5671
"1675";"Osrednjeslovenska";"18";"2009";11850;5560;6290
"1676";"Osrednjeslovenska";"18";"2010";11461;5441;6020
"1677";"Osrednjeslovenska";"18";"2011";10855;5098;5757
"1678";"Osrednjeslovenska";"18";"2012";11144;5384;5760
"1679";"Osrednjeslovenska";"18";"2013";11244;5619;5625
"1680";"Osrednjeslovenska";"18";"2014";11443;5841;5602
"1681";"Osrednjeslovenska";"18";"2015";11535;6026;5509
"1682";"Osrednjeslovenska";"18";"2016";11661;6056;5605
"1683";"Osrednjeslovenska";"18";"2017 (začasni podatki)";12356;6558;5798
"1684";"Osrednjeslovenska";"19";"2009";14338;7656;6682
"1685";"Osrednjeslovenska";"19";"2010";13778;7411;6367
"1686";"Osrednjeslovenska";"19";"2011";13225;7072;6153
"1687";"Osrednjeslovenska";"19";"2012";12722;6957;5765
"1688";"Osrednjeslovenska";"19";"2013";12904;7000;5904
"1689";"Osrednjeslovenska";"19";"2014";13099;7122;5977
"1690";"Osrednjeslovenska";"19";"2015";13090;7289;5801
"1691";"Osrednjeslovenska";"19";"2016";13474;7404;6070
"1692";"Osrednjeslovenska";"19";"2017 (začasni podatki)";14198;7934;6264
"1693";"Osrednjeslovenska";"20";"2009";16366;9983;6383
"1694";"Osrednjeslovenska";"20";"2010";15651;9544;6107
"1695";"Osrednjeslovenska";"20";"2011";14989;9091;5898
"1696";"Osrednjeslovenska";"20";"2012";14464;8764;5700
"1697";"Osrednjeslovenska";"20";"2013";14163;8503;5660
"1698";"Osrednjeslovenska";"20";"2014";14470;8622;5848
"1699";"Osrednjeslovenska";"20";"2015";14315;8583;5732
"1700";"Osrednjeslovenska";"20";"2016";14656;8761;5895
"1701";"Osrednjeslovenska";"20";"2017 (začasni podatki)";15253;8977;6276
"1702";"Gorenjska";"Razred neto - SKUPAJ";"2009";49840;27774;22066
"1703";"Gorenjska";"Razred neto - SKUPAJ";"2010";47274;26216;21058
"1704";"Gorenjska";"Razred neto - SKUPAJ";"2011";47791;26177;21614
"1705";"Gorenjska";"Razred neto - SKUPAJ";"2012";45756;25181;20575
"1706";"Gorenjska";"Razred neto - SKUPAJ";"2013";46243;25360;20883
"1707";"Gorenjska";"Razred neto - SKUPAJ";"2014";46221;25592;20629
"1708";"Gorenjska";"Razred neto - SKUPAJ";"2015";46563;25935;20628
"1709";"Gorenjska";"Razred neto - SKUPAJ";"2016";47506;26561;20945
"1710";"Gorenjska";"Razred neto - SKUPAJ";"2017 (začasni podatki)";48633;27368;21265
"1711";"Gorenjska";"01";"2009";2266;1296;970
"1712";"Gorenjska";"01";"2010";2137;1164;973
"1713";"Gorenjska";"01";"2011";2252;1134;1118
"1714";"Gorenjska";"01";"2012";2297;1141;1156
"1715";"Gorenjska";"01";"2013";2286;1077;1209
"1716";"Gorenjska";"01";"2014";2222;1014;1208
"1717";"Gorenjska";"01";"2015";2312;1035;1277
"1718";"Gorenjska";"01";"2016";2168;1044;1124
"1719";"Gorenjska";"01";"2017 (začasni podatki)";2100;1036;1064
"1720";"Gorenjska";"02";"2009";2155;972;1183
"1721";"Gorenjska";"02";"2010";2210;1018;1192
"1722";"Gorenjska";"02";"2011";2359;933;1426
"1723";"Gorenjska";"02";"2012";2081;856;1225
"1724";"Gorenjska";"02";"2013";2247;868;1379
"1725";"Gorenjska";"02";"2014";2045;775;1270
"1726";"Gorenjska";"02";"2015";2046;870;1176
"1727";"Gorenjska";"02";"2016";2074;878;1196
"1728";"Gorenjska";"02";"2017 (začasni podatki)";2111;964;1147
"1729";"Gorenjska";"03";"2009";2456;998;1458
"1730";"Gorenjska";"03";"2010";2384;973;1411
"1731";"Gorenjska";"03";"2011";2287;942;1345
"1732";"Gorenjska";"03";"2012";2316;1031;1285
"1733";"Gorenjska";"03";"2013";2089;959;1130
"1734";"Gorenjska";"03";"2014";2307;1033;1274
"1735";"Gorenjska";"03";"2015";2224;975;1249
"1736";"Gorenjska";"03";"2016";2218;968;1250
"1737";"Gorenjska";"03";"2017 (začasni podatki)";2113;948;1165
"1738";"Gorenjska";"04";"2009";2611;1069;1542
"1739";"Gorenjska";"04";"2010";2596;1154;1442
"1740";"Gorenjska";"04";"2011";2692;1157;1535
"1741";"Gorenjska";"04";"2012";2238;1018;1220
"1742";"Gorenjska";"04";"2013";2231;941;1290
"1743";"Gorenjska";"04";"2014";2369;979;1390
"1744";"Gorenjska";"04";"2015";2280;946;1334
"1745";"Gorenjska";"04";"2016";2251;928;1323
"1746";"Gorenjska";"04";"2017 (začasni podatki)";2168;947;1221
"1747";"Gorenjska";"05";"2009";2857;1394;1463
"1748";"Gorenjska";"05";"2010";2470;1197;1273
"1749";"Gorenjska";"05";"2011";2539;1193;1346
"1750";"Gorenjska";"05";"2012";2306;1066;1240
"1751";"Gorenjska";"05";"2013";2322;1042;1280
"1752";"Gorenjska";"05";"2014";2224;1091;1133
"1753";"Gorenjska";"05";"2015";2345;1109;1236
"1754";"Gorenjska";"05";"2016";2327;1097;1230
"1755";"Gorenjska";"05";"2017 (začasni podatki)";2479;1072;1407
"1756";"Gorenjska";"06";"2009";2827;1558;1269
"1757";"Gorenjska";"06";"2010";2515;1278;1237
"1758";"Gorenjska";"06";"2011";2499;1263;1236
"1759";"Gorenjska";"06";"2012";2345;1205;1140
"1760";"Gorenjska";"06";"2013";2335;1209;1126
"1761";"Gorenjska";"06";"2014";2380;1248;1132
"1762";"Gorenjska";"06";"2015";2336;1231;1105
"1763";"Gorenjska";"06";"2016";2357;1229;1128
"1764";"Gorenjska";"06";"2017 (začasni podatki)";2506;1253;1253
"1765";"Gorenjska";"07";"2009";2802;1657;1145
"1766";"Gorenjska";"07";"2010";2564;1472;1092
"1767";"Gorenjska";"07";"2011";2482;1420;1062
"1768";"Gorenjska";"07";"2012";2397;1342;1055
"1769";"Gorenjska";"07";"2013";2401;1314;1087
"1770";"Gorenjska";"07";"2014";2317;1267;1050
"1771";"Gorenjska";"07";"2015";2318;1263;1055
"1772";"Gorenjska";"07";"2016";2509;1347;1162
"1773";"Gorenjska";"07";"2017 (začasni podatki)";2471;1353;1118
"1774";"Gorenjska";"08";"2009";2862;1794;1068
"1775";"Gorenjska";"08";"2010";2529;1522;1007
"1776";"Gorenjska";"08";"2011";2589;1523;1066
"1777";"Gorenjska";"08";"2012";2535;1466;1069
"1778";"Gorenjska";"08";"2013";2524;1442;1082
"1779";"Gorenjska";"08";"2014";2456;1415;1041
"1780";"Gorenjska";"08";"2015";2415;1423;992
"1781";"Gorenjska";"08";"2016";2472;1466;1006
"1782";"Gorenjska";"08";"2017 (začasni podatki)";2671;1620;1051
"1783";"Gorenjska";"09";"2009";2793;1805;988
"1784";"Gorenjska";"09";"2010";2693;1711;982
"1785";"Gorenjska";"09";"2011";2724;1739;985
"1786";"Gorenjska";"09";"2012";2462;1577;885
"1787";"Gorenjska";"09";"2013";2636;1629;1007
"1788";"Gorenjska";"09";"2014";2615;1635;980
"1789";"Gorenjska";"09";"2015";2502;1522;980
"1790";"Gorenjska";"09";"2016";2610;1613;997
"1791";"Gorenjska";"09";"2017 (začasni podatki)";2727;1694;1033
"1792";"Gorenjska";"10";"2009";2750;1853;897
"1793";"Gorenjska";"10";"2010";2689;1721;968
"1794";"Gorenjska";"10";"2011";2741;1761;980
"1795";"Gorenjska";"10";"2012";2495;1564;931
"1796";"Gorenjska";"10";"2013";2540;1595;945
"1797";"Gorenjska";"10";"2014";2399;1508;891
"1798";"Gorenjska";"10";"2015";2405;1494;911
"1799";"Gorenjska";"10";"2016";2563;1585;978
"1800";"Gorenjska";"10";"2017 (začasni podatki)";2670;1681;989
"1801";"Gorenjska";"11";"2009";2772;1738;1034
"1802";"Gorenjska";"11";"2010";2493;1551;942
"1803";"Gorenjska";"11";"2011";2350;1492;858
"1804";"Gorenjska";"11";"2012";2360;1508;852
"1805";"Gorenjska";"11";"2013";2413;1471;942
"1806";"Gorenjska";"11";"2014";2466;1506;960
"1807";"Gorenjska";"11";"2015";2532;1538;994
"1808";"Gorenjska";"11";"2016";2611;1621;990
"1809";"Gorenjska";"11";"2017 (začasni podatki)";2774;1719;1055
"1810";"Gorenjska";"12";"2009";2611;1620;991
"1811";"Gorenjska";"12";"2010";2473;1534;939
"1812";"Gorenjska";"12";"2011";2499;1568;931
"1813";"Gorenjska";"12";"2012";2493;1527;966
"1814";"Gorenjska";"12";"2013";2536;1599;937
"1815";"Gorenjska";"12";"2014";2458;1529;929
"1816";"Gorenjska";"12";"2015";2518;1618;900
"1817";"Gorenjska";"12";"2016";2644;1681;963
"1818";"Gorenjska";"12";"2017 (začasni podatki)";2722;1725;997
"1819";"Gorenjska";"13";"2009";2512;1556;956
"1820";"Gorenjska";"13";"2010";2402;1520;882
"1821";"Gorenjska";"13";"2011";2494;1522;972
"1822";"Gorenjska";"13";"2012";2471;1514;957
"1823";"Gorenjska";"13";"2013";2498;1549;949
"1824";"Gorenjska";"13";"2014";2551;1612;939
"1825";"Gorenjska";"13";"2015";2593;1609;984
"1826";"Gorenjska";"13";"2016";2732;1714;1018
"1827";"Gorenjska";"13";"2017 (začasni podatki)";2807;1784;1023
"1828";"Gorenjska";"14";"2009";2437;1441;996
"1829";"Gorenjska";"14";"2010";2413;1482;931
"1830";"Gorenjska";"14";"2011";2490;1523;967
"1831";"Gorenjska";"14";"2012";2312;1401;911
"1832";"Gorenjska";"14";"2013";2360;1437;923
"1833";"Gorenjska";"14";"2014";2483;1541;942
"1834";"Gorenjska";"14";"2015";2564;1629;935
"1835";"Gorenjska";"14";"2016";2539;1585;954
"1836";"Gorenjska";"14";"2017 (začasni podatki)";2602;1618;984
"1837";"Gorenjska";"15";"2009";2297;1335;962
"1838";"Gorenjska";"15";"2010";2245;1334;911
"1839";"Gorenjska";"15";"2011";2333;1393;940
"1840";"Gorenjska";"15";"2012";2296;1332;964
"1841";"Gorenjska";"15";"2013";2290;1328;962
"1842";"Gorenjska";"15";"2014";2364;1423;941
"1843";"Gorenjska";"15";"2015";2431;1464;967
"1844";"Gorenjska";"15";"2016";2365;1400;965
"1845";"Gorenjska";"15";"2017 (začasni podatki)";2476;1474;1002
"1846";"Gorenjska";"16";"2009";2275;1226;1049
"1847";"Gorenjska";"16";"2010";2265;1238;1027
"1848";"Gorenjska";"16";"2011";2296;1253;1043
"1849";"Gorenjska";"16";"2012";2191;1187;1004
"1850";"Gorenjska";"16";"2013";2253;1215;1038
"1851";"Gorenjska";"16";"2014";2287;1274;1013
"1852";"Gorenjska";"16";"2015";2300;1266;1034
"1853";"Gorenjska";"16";"2016";2428;1306;1122
"1854";"Gorenjska";"16";"2017 (začasni podatki)";2455;1288;1167
"1855";"Gorenjska";"17";"2009";2290;1075;1215
"1856";"Gorenjska";"17";"2010";2238;1040;1198
"1857";"Gorenjska";"17";"2011";2226;1042;1184
"1858";"Gorenjska";"17";"2012";2276;1072;1204
"1859";"Gorenjska";"17";"2013";2238;1057;1181
"1860";"Gorenjska";"17";"2014";2229;1089;1140
"1861";"Gorenjska";"17";"2015";2339;1180;1159
"1862";"Gorenjska";"17";"2016";2349;1161;1188
"1863";"Gorenjska";"17";"2017 (začasni podatki)";2389;1195;1194
"1864";"Gorenjska";"18";"2009";2361;1060;1301
"1865";"Gorenjska";"18";"2010";2197;1035;1162
"1866";"Gorenjska";"18";"2011";2205;1053;1152
"1867";"Gorenjska";"18";"2012";2136;1059;1077
"1868";"Gorenjska";"18";"2013";2091;1071;1020
"1869";"Gorenjska";"18";"2014";2167;1112;1055
"1870";"Gorenjska";"18";"2015";2104;1098;1006
"1871";"Gorenjska";"18";"2016";2246;1226;1020
"1872";"Gorenjska";"18";"2017 (začasni podatki)";2291;1267;1024
"1873";"Gorenjska";"19";"2009";2044;1071;973
"1874";"Gorenjska";"19";"2010";1961;1060;901
"1875";"Gorenjska";"19";"2011";1911;1046;865
"1876";"Gorenjska";"19";"2012";1874;1026;848
"1877";"Gorenjska";"19";"2013";1859;1083;776
"1878";"Gorenjska";"19";"2014";1795;1053;742
"1879";"Gorenjska";"19";"2015";1858;1123;735
"1880";"Gorenjska";"19";"2016";1865;1145;720
"1881";"Gorenjska";"19";"2017 (začasni podatki)";1939;1187;752
"1882";"Gorenjska";"20";"2009";1862;1256;606
"1883";"Gorenjska";"20";"2010";1800;1212;588
"1884";"Gorenjska";"20";"2011";1823;1220;603
"1885";"Gorenjska";"20";"2012";1875;1289;586
"1886";"Gorenjska";"20";"2013";2094;1474;620
"1887";"Gorenjska";"20";"2014";2087;1488;599
"1888";"Gorenjska";"20";"2015";2141;1542;599
"1889";"Gorenjska";"20";"2016";2178;1567;611
"1890";"Gorenjska";"20";"2017 (začasni podatki)";2162;1543;619
"1891";"Primorsko-notranjska";"Razred neto - SKUPAJ";"2009";12182;6848;5334
"1892";"Primorsko-notranjska";"Razred neto - SKUPAJ";"2010";12375;6863;5512
"1893";"Primorsko-notranjska";"Razred neto - SKUPAJ";"2011";11037;5899;5138
"1894";"Primorsko-notranjska";"Razred neto - SKUPAJ";"2012";10442;5644;4798
"1895";"Primorsko-notranjska";"Razred neto - SKUPAJ";"2013";10062;5408;4654
"1896";"Primorsko-notranjska";"Razred neto - SKUPAJ";"2014";10627;5771;4856
"1897";"Primorsko-notranjska";"Razred neto - SKUPAJ";"2015";10286;5611;4675
"1898";"Primorsko-notranjska";"Razred neto - SKUPAJ";"2016";10286;5533;4753
"1899";"Primorsko-notranjska";"Razred neto - SKUPAJ";"2017 (začasni podatki)";10182;5524;4658
"1900";"Primorsko-notranjska";"01";"2009";701;441;260
"1901";"Primorsko-notranjska";"01";"2010";787;368;419
"1902";"Primorsko-notranjska";"01";"2011";655;277;378
"1903";"Primorsko-notranjska";"01";"2012";629;301;328
"1904";"Primorsko-notranjska";"01";"2013";650;318;332
"1905";"Primorsko-notranjska";"01";"2014";752;326;426
"1906";"Primorsko-notranjska";"01";"2015";717;285;432
"1907";"Primorsko-notranjska";"01";"2016";548;231;317
"1908";"Primorsko-notranjska";"01";"2017 (začasni podatki)";565;267;298
"1909";"Primorsko-notranjska";"02";"2009";843;404;439
"1910";"Primorsko-notranjska";"02";"2010";842;409;433
"1911";"Primorsko-notranjska";"02";"2011";839;391;448
"1912";"Primorsko-notranjska";"02";"2012";677;268;409
"1913";"Primorsko-notranjska";"02";"2013";678;268;410
"1914";"Primorsko-notranjska";"02";"2014";658;248;410
"1915";"Primorsko-notranjska";"02";"2015";720;286;434
"1916";"Primorsko-notranjska";"02";"2016";641;260;381
"1917";"Primorsko-notranjska";"02";"2017 (začasni podatki)";612;266;346
"1918";"Primorsko-notranjska";"03";"2009";896;396;500
"1919";"Primorsko-notranjska";"03";"2010";847;372;475
"1920";"Primorsko-notranjska";"03";"2011";748;350;398
"1921";"Primorsko-notranjska";"03";"2012";725;332;393
"1922";"Primorsko-notranjska";"03";"2013";618;275;343
"1923";"Primorsko-notranjska";"03";"2014";711;326;385
"1924";"Primorsko-notranjska";"03";"2015";638;313;325
"1925";"Primorsko-notranjska";"03";"2016";639;279;360
"1926";"Primorsko-notranjska";"03";"2017 (začasni podatki)";620;284;336
"1927";"Primorsko-notranjska";"04";"2009";696;336;360
"1928";"Primorsko-notranjska";"04";"2010";749;365;384
"1929";"Primorsko-notranjska";"04";"2011";660;308;352
"1930";"Primorsko-notranjska";"04";"2012";641;270;371
"1931";"Primorsko-notranjska";"04";"2013";680;277;403
"1932";"Primorsko-notranjska";"04";"2014";660;311;349
"1933";"Primorsko-notranjska";"04";"2015";637;288;349
"1934";"Primorsko-notranjska";"04";"2016";665;281;384
"1935";"Primorsko-notranjska";"04";"2017 (začasni podatki)";650;283;367
"1936";"Primorsko-notranjska";"05";"2009";704;338;366
"1937";"Primorsko-notranjska";"05";"2010";726;376;350
"1938";"Primorsko-notranjska";"05";"2011";663;349;314
"1939";"Primorsko-notranjska";"05";"2012";646;310;336
"1940";"Primorsko-notranjska";"05";"2013";656;316;340
"1941";"Primorsko-notranjska";"05";"2014";693;364;329
"1942";"Primorsko-notranjska";"05";"2015";645;337;308
"1943";"Primorsko-notranjska";"05";"2016";674;312;362
"1944";"Primorsko-notranjska";"05";"2017 (začasni podatki)";662;297;365
"1945";"Primorsko-notranjska";"06";"2009";693;411;282
"1946";"Primorsko-notranjska";"06";"2010";771;418;353
"1947";"Primorsko-notranjska";"06";"2011";662;338;324
"1948";"Primorsko-notranjska";"06";"2012";617;331;286
"1949";"Primorsko-notranjska";"06";"2013";600;349;251
"1950";"Primorsko-notranjska";"06";"2014";648;363;285
"1951";"Primorsko-notranjska";"06";"2015";583;336;247
"1952";"Primorsko-notranjska";"06";"2016";616;345;271
"1953";"Primorsko-notranjska";"06";"2017 (začasni podatki)";539;306;233
"1954";"Primorsko-notranjska";"07";"2009";661;380;281
"1955";"Primorsko-notranjska";"07";"2010";685;390;295
"1956";"Primorsko-notranjska";"07";"2011";611;324;287
"1957";"Primorsko-notranjska";"07";"2012";602;355;247
"1958";"Primorsko-notranjska";"07";"2013";523;328;195
"1959";"Primorsko-notranjska";"07";"2014";585;347;238
"1960";"Primorsko-notranjska";"07";"2015";580;338;242
"1961";"Primorsko-notranjska";"07";"2016";608;373;235
"1962";"Primorsko-notranjska";"07";"2017 (začasni podatki)";582;360;222
"1963";"Primorsko-notranjska";"08";"2009";715;425;290
"1964";"Primorsko-notranjska";"08";"2010";703;435;268
"1965";"Primorsko-notranjska";"08";"2011";570;350;220
"1966";"Primorsko-notranjska";"08";"2012";571;387;184
"1967";"Primorsko-notranjska";"08";"2013";574;391;183
"1968";"Primorsko-notranjska";"08";"2014";576;378;198
"1969";"Primorsko-notranjska";"08";"2015";585;397;188
"1970";"Primorsko-notranjska";"08";"2016";594;379;215
"1971";"Primorsko-notranjska";"08";"2017 (začasni podatki)";608;396;212
"1972";"Primorsko-notranjska";"09";"2009";617;391;226
"1973";"Primorsko-notranjska";"09";"2010";698;445;253
"1974";"Primorsko-notranjska";"09";"2011";602;394;208
"1975";"Primorsko-notranjska";"09";"2012";557;366;191
"1976";"Primorsko-notranjska";"09";"2013";536;372;164
"1977";"Primorsko-notranjska";"09";"2014";602;396;206
"1978";"Primorsko-notranjska";"09";"2015";530;337;193
"1979";"Primorsko-notranjska";"09";"2016";634;427;207
"1980";"Primorsko-notranjska";"09";"2017 (začasni podatki)";617;419;198
"1981";"Primorsko-notranjska";"10";"2009";574;380;194
"1982";"Primorsko-notranjska";"10";"2010";610;402;208
"1983";"Primorsko-notranjska";"10";"2011";602;372;230
"1984";"Primorsko-notranjska";"10";"2012";556;351;205
"1985";"Primorsko-notranjska";"10";"2013";577;374;203
"1986";"Primorsko-notranjska";"10";"2014";597;389;208
"1987";"Primorsko-notranjska";"10";"2015";576;371;205
"1988";"Primorsko-notranjska";"10";"2016";563;368;195
"1989";"Primorsko-notranjska";"10";"2017 (začasni podatki)";563;362;201
"1990";"Primorsko-notranjska";"11";"2009";599;397;202
"1991";"Primorsko-notranjska";"11";"2010";651;419;232
"1992";"Primorsko-notranjska";"11";"2011";578;360;218
"1993";"Primorsko-notranjska";"11";"2012";577;379;198
"1994";"Primorsko-notranjska";"11";"2013";522;334;188
"1995";"Primorsko-notranjska";"11";"2014";548;362;186
"1996";"Primorsko-notranjska";"11";"2015";556;372;184
"1997";"Primorsko-notranjska";"11";"2016";525;333;192
"1998";"Primorsko-notranjska";"11";"2017 (začasni podatki)";551;334;217
"1999";"Primorsko-notranjska";"12";"2009";602;389;213
"2000";"Primorsko-notranjska";"12";"2010";605;393;212
"2001";"Primorsko-notranjska";"12";"2011";543;354;189
"2002";"Primorsko-notranjska";"12";"2012";524;332;192
"2003";"Primorsko-notranjska";"12";"2013";469;292;177
"2004";"Primorsko-notranjska";"12";"2014";528;333;195
"2005";"Primorsko-notranjska";"12";"2015";525;339;186
"2006";"Primorsko-notranjska";"12";"2016";536;333;203
"2007";"Primorsko-notranjska";"12";"2017 (začasni podatki)";520;313;207
"2008";"Primorsko-notranjska";"13";"2009";653;412;241
"2009";"Primorsko-notranjska";"13";"2010";551;365;186
"2010";"Primorsko-notranjska";"13";"2011";506;299;207
"2011";"Primorsko-notranjska";"13";"2012";507;325;182
"2012";"Primorsko-notranjska";"13";"2013";475;277;198
"2013";"Primorsko-notranjska";"13";"2014";478;298;180
"2014";"Primorsko-notranjska";"13";"2015";464;294;170
"2015";"Primorsko-notranjska";"13";"2016";482;297;185
"2016";"Primorsko-notranjska";"13";"2017 (začasni podatki)";528;319;209
"2017";"Primorsko-notranjska";"14";"2009";633;397;236
"2018";"Primorsko-notranjska";"14";"2010";590;368;222
"2019";"Primorsko-notranjska";"14";"2011";527;312;215
"2020";"Primorsko-notranjska";"14";"2012";465;284;181
"2021";"Primorsko-notranjska";"14";"2013";430;262;168
"2022";"Primorsko-notranjska";"14";"2014";460;269;191
"2023";"Primorsko-notranjska";"14";"2015";470;281;189
"2024";"Primorsko-notranjska";"14";"2016";486;282;204
"2025";"Primorsko-notranjska";"14";"2017 (začasni podatki)";479;272;207
"2026";"Primorsko-notranjska";"15";"2009";500;298;202
"2027";"Primorsko-notranjska";"15";"2010";547;321;226
"2028";"Primorsko-notranjska";"15";"2011";475;282;193
"2029";"Primorsko-notranjska";"15";"2012";420;235;185
"2030";"Primorsko-notranjska";"15";"2013";425;210;215
"2031";"Primorsko-notranjska";"15";"2014";471;244;227
"2032";"Primorsko-notranjska";"15";"2015";481;261;220
"2033";"Primorsko-notranjska";"15";"2016";443;246;197
"2034";"Primorsko-notranjska";"15";"2017 (začasni podatki)";459;262;197
"2035";"Primorsko-notranjska";"16";"2009";527;287;240
"2036";"Primorsko-notranjska";"16";"2010";493;257;236
"2037";"Primorsko-notranjska";"16";"2011";447;214;233
"2038";"Primorsko-notranjska";"16";"2012";431;200;231
"2039";"Primorsko-notranjska";"16";"2013";401;184;217
"2040";"Primorsko-notranjska";"16";"2014";395;199;196
"2041";"Primorsko-notranjska";"16";"2015";372;183;189
"2042";"Primorsko-notranjska";"16";"2016";428;189;239
"2043";"Primorsko-notranjska";"16";"2017 (začasni podatki)";447;203;244
"2044";"Primorsko-notranjska";"17";"2009";500;229;271
"2045";"Primorsko-notranjska";"17";"2010";507;236;271
"2046";"Primorsko-notranjska";"17";"2011";424;158;266
"2047";"Primorsko-notranjska";"17";"2012";392;161;231
"2048";"Primorsko-notranjska";"17";"2013";405;152;253
"2049";"Primorsko-notranjska";"17";"2014";423;162;261
"2050";"Primorsko-notranjska";"17";"2015";383;143;240
"2051";"Primorsko-notranjska";"17";"2016";417;157;260
"2052";"Primorsko-notranjska";"17";"2017 (začasni podatki)";396;139;257
"2053";"Primorsko-notranjska";"18";"2009";464;203;261
"2054";"Primorsko-notranjska";"18";"2010";441;189;252
"2055";"Primorsko-notranjska";"18";"2011";396;161;235
"2056";"Primorsko-notranjska";"18";"2012";388;159;229
"2057";"Primorsko-notranjska";"18";"2013";351;137;214
"2058";"Primorsko-notranjska";"18";"2014";344;147;197
"2059";"Primorsko-notranjska";"18";"2015";329;145;184
"2060";"Primorsko-notranjska";"18";"2016";322;154;168
"2061";"Primorsko-notranjska";"18";"2017 (začasni podatki)";330;158;172
"2062";"Primorsko-notranjska";"19";"2009";353;167;186
"2063";"Primorsko-notranjska";"19";"2010";337;176;161
"2064";"Primorsko-notranjska";"19";"2011";295;143;152
"2065";"Primorsko-notranjska";"19";"2012";303;149;154
"2066";"Primorsko-notranjska";"19";"2013";270;139;131
"2067";"Primorsko-notranjska";"19";"2014";264;138;126
"2068";"Primorsko-notranjska";"19";"2015";261;137;124
"2069";"Primorsko-notranjska";"19";"2016";237;124;113
"2070";"Primorsko-notranjska";"19";"2017 (začasni podatki)";235;130;105
"2071";"Primorsko-notranjska";"20";"2009";251;167;84
"2072";"Primorsko-notranjska";"20";"2010";235;159;76
"2073";"Primorsko-notranjska";"20";"2011";234;163;71
"2074";"Primorsko-notranjska";"20";"2012";214;149;65
"2075";"Primorsko-notranjska";"20";"2013";222;153;69
"2076";"Primorsko-notranjska";"20";"2014";234;171;63
"2077";"Primorsko-notranjska";"20";"2015";234;168;66
"2078";"Primorsko-notranjska";"20";"2016";228;163;65
"2079";"Primorsko-notranjska";"20";"2017 (začasni podatki)";219;154;65
"2080";"Goriška";"Razred neto - SKUPAJ";"2009";33332;18671;14661
"2081";"Goriška";"Razred neto - SKUPAJ";"2010";31604;17543;14061
"2082";"Goriška";"Razred neto - SKUPAJ";"2011";30448;16415;14033
"2083";"Goriška";"Razred neto - SKUPAJ";"2012";29657;16025;13632
"2084";"Goriška";"Razred neto - SKUPAJ";"2013";29142;15734;13408
"2085";"Goriška";"Razred neto - SKUPAJ";"2014";29537;16028;13509
"2086";"Goriška";"Razred neto - SKUPAJ";"2015";29201;15886;13315
"2087";"Goriška";"Razred neto - SKUPAJ";"2016";29425;16158;13267
"2088";"Goriška";"Razred neto - SKUPAJ";"2017 (začasni podatki)";30493;16676;13817
"2089";"Goriška";"01";"2009";1410;892;518
"2090";"Goriška";"01";"2010";1280;764;516
"2091";"Goriška";"01";"2011";1129;582;547
"2092";"Goriška";"01";"2012";1133;517;616
"2093";"Goriška";"01";"2013";1082;499;583
"2094";"Goriška";"01";"2014";1188;547;641
"2095";"Goriška";"01";"2015";1266;538;728
"2096";"Goriška";"01";"2016";1146;515;631
"2097";"Goriška";"01";"2017 (začasni podatki)";1078;465;613
"2098";"Goriška";"02";"2009";1291;613;678
"2099";"Goriška";"02";"2010";1206;582;624
"2100";"Goriška";"02";"2011";1347;568;779
"2101";"Goriška";"02";"2012";1225;511;714
"2102";"Goriška";"02";"2013";1384;552;832
"2103";"Goriška";"02";"2014";1248;494;754
"2104";"Goriška";"02";"2015";1216;481;735
"2105";"Goriška";"02";"2016";1203;508;695
"2106";"Goriška";"02";"2017 (začasni podatki)";1297;527;770
"2107";"Goriška";"03";"2009";1413;603;810
"2108";"Goriška";"03";"2010";1472;602;870
"2109";"Goriška";"03";"2011";1360;552;808
"2110";"Goriška";"03";"2012";1522;621;901
"2111";"Goriška";"03";"2013";1347;634;713
"2112";"Goriška";"03";"2014";1640;788;852
"2113";"Goriška";"03";"2015";1505;660;845
"2114";"Goriška";"03";"2016";1460;671;789
"2115";"Goriška";"03";"2017 (začasni podatki)";1445;681;764
"2116";"Goriška";"04";"2009";1829;767;1062
"2117";"Goriška";"04";"2010";1570;655;915
"2118";"Goriška";"04";"2011";1503;649;854
"2119";"Goriška";"04";"2012";1579;735;844
"2120";"Goriška";"04";"2013";1425;596;829
"2121";"Goriška";"04";"2014";1496;659;837
"2122";"Goriška";"04";"2015";1586;697;889
"2123";"Goriška";"04";"2016";1484;632;852
"2124";"Goriška";"04";"2017 (začasni podatki)";1582;660;922
"2125";"Goriška";"05";"2009";1760;835;925
"2126";"Goriška";"05";"2010";1603;727;876
"2127";"Goriška";"05";"2011";1618;795;823
"2128";"Goriška";"05";"2012";1616;787;829
"2129";"Goriška";"05";"2013";1543;713;830
"2130";"Goriška";"05";"2014";1601;743;858
"2131";"Goriška";"05";"2015";1535;698;837
"2132";"Goriška";"05";"2016";1483;700;783
"2133";"Goriška";"05";"2017 (začasni podatki)";1686;802;884
"2134";"Goriška";"06";"2009";1820;972;848
"2135";"Goriška";"06";"2010";1741;887;854
"2136";"Goriška";"06";"2011";1665;842;823
"2137";"Goriška";"06";"2012";1607;850;757
"2138";"Goriška";"06";"2013";1571;806;765
"2139";"Goriška";"06";"2014";1608;827;781
"2140";"Goriška";"06";"2015";1628;885;743
"2141";"Goriška";"06";"2016";1593;862;731
"2142";"Goriška";"06";"2017 (začasni podatki)";1769;928;841
"2143";"Goriška";"07";"2009";1896;1097;799
"2144";"Goriška";"07";"2010";1665;982;683
"2145";"Goriška";"07";"2011";1698;1009;689
"2146";"Goriška";"07";"2012";1653;949;704
"2147";"Goriška";"07";"2013";1639;935;704
"2148";"Goriška";"07";"2014";1579;915;664
"2149";"Goriška";"07";"2015";1569;883;686
"2150";"Goriška";"07";"2016";1729;991;738
"2151";"Goriška";"07";"2017 (začasni podatki)";1730;957;773
"2152";"Goriška";"08";"2009";1816;1177;639
"2153";"Goriška";"08";"2010";1706;1045;661
"2154";"Goriška";"08";"2011";1689;991;698
"2155";"Goriška";"08";"2012";1629;968;661
"2156";"Goriška";"08";"2013";1680;994;686
"2157";"Goriška";"08";"2014";1633;979;654
"2158";"Goriška";"08";"2015";1696;1014;682
"2159";"Goriška";"08";"2016";1593;968;625
"2160";"Goriška";"08";"2017 (začasni podatki)";1830;1125;705
"2161";"Goriška";"09";"2009";1890;1271;619
"2162";"Goriška";"09";"2010";1787;1123;664
"2163";"Goriška";"09";"2011";1676;1030;646
"2164";"Goriška";"09";"2012";1590;994;596
"2165";"Goriška";"09";"2013";1606;1005;601
"2166";"Goriška";"09";"2014";1716;1024;692
"2167";"Goriška";"09";"2015";1672;1006;666
"2168";"Goriška";"09";"2016";1712;1042;670
"2169";"Goriška";"09";"2017 (začasni podatki)";1770;1082;688
"2170";"Goriška";"10";"2009";1823;1216;607
"2171";"Goriška";"10";"2010";1831;1174;657
"2172";"Goriška";"10";"2011";1735;1048;687
"2173";"Goriška";"10";"2012";1651;1036;615
"2174";"Goriška";"10";"2013";1700;1014;686
"2175";"Goriška";"10";"2014";1682;1042;640
"2176";"Goriška";"10";"2015";1657;1018;639
"2177";"Goriška";"10";"2016";1693;1004;689
"2178";"Goriška";"10";"2017 (začasni podatki)";1746;1037;709
"2179";"Goriška";"11";"2009";2050;1336;714
"2180";"Goriška";"11";"2010";1805;1140;665
"2181";"Goriška";"11";"2011";1705;1013;692
"2182";"Goriška";"11";"2012";1622;957;665
"2183";"Goriška";"11";"2013";1682;1042;640
"2184";"Goriška";"11";"2014";1578;932;646
"2185";"Goriška";"11";"2015";1666;1014;652
"2186";"Goriška";"11";"2016";1631;969;662
"2187";"Goriška";"11";"2017 (začasni podatki)";1712;1060;652
"2188";"Goriška";"12";"2009";1804;1038;766
"2189";"Goriška";"12";"2010";1758;1104;654
"2190";"Goriška";"12";"2011";1718;1002;716
"2191";"Goriška";"12";"2012";1617;946;671
"2192";"Goriška";"12";"2013";1553;922;631
"2193";"Goriška";"12";"2014";1560;951;609
"2194";"Goriška";"12";"2015";1502;924;578
"2195";"Goriška";"12";"2016";1574;979;595
"2196";"Goriška";"12";"2017 (začasni podatki)";1626;981;645
"2197";"Goriška";"13";"2009";1674;967;707
"2198";"Goriška";"13";"2010";1784;1074;710
"2199";"Goriška";"13";"2011";1594;921;673
"2200";"Goriška";"13";"2012";1518;882;636
"2201";"Goriška";"13";"2013";1621;974;647
"2202";"Goriška";"13";"2014";1549;915;634
"2203";"Goriška";"13";"2015";1492;894;598
"2204";"Goriška";"13";"2016";1598;950;648
"2205";"Goriška";"13";"2017 (začasni podatki)";1649;997;652
"2206";"Goriška";"14";"2009";1694;988;706
"2207";"Goriška";"14";"2010";1594;936;658
"2208";"Goriška";"14";"2011";1545;890;655
"2209";"Goriška";"14";"2012";1500;884;616
"2210";"Goriška";"14";"2013";1440;826;614
"2211";"Goriška";"14";"2014";1444;819;625
"2212";"Goriška";"14";"2015";1497;883;614
"2213";"Goriška";"14";"2016";1549;942;607
"2214";"Goriška";"14";"2017 (začasni podatki)";1556;924;632
"2215";"Goriška";"15";"2009";1614;888;726
"2216";"Goriška";"15";"2010";1566;896;670
"2217";"Goriška";"15";"2011";1488;857;631
"2218";"Goriška";"15";"2012";1470;818;652
"2219";"Goriška";"15";"2013";1440;804;636
"2220";"Goriška";"15";"2014";1456;836;620
"2221";"Goriška";"15";"2015";1437;828;609
"2222";"Goriška";"15";"2016";1484;843;641
"2223";"Goriška";"15";"2017 (začasni podatki)";1486;833;653
"2224";"Goriška";"16";"2009";1571;870;701
"2225";"Goriška";"16";"2010";1569;857;712
"2226";"Goriška";"16";"2011";1532;837;695
"2227";"Goriška";"16";"2012";1487;794;693
"2228";"Goriška";"16";"2013";1420;718;702
"2229";"Goriška";"16";"2014";1479;772;707
"2230";"Goriška";"16";"2015";1448;768;680
"2231";"Goriška";"16";"2016";1444;737;707
"2232";"Goriška";"16";"2017 (začasni podatki)";1436;737;699
"2233";"Goriška";"17";"2009";1672;760;912
"2234";"Goriška";"17";"2010";1619;719;900
"2235";"Goriška";"17";"2011";1527;646;881
"2236";"Goriška";"17";"2012";1415;610;805
"2237";"Goriška";"17";"2013";1467;638;829
"2238";"Goriška";"17";"2014";1483;693;790
"2239";"Goriška";"17";"2015";1413;664;749
"2240";"Goriška";"17";"2016";1460;682;778
"2241";"Goriška";"17";"2017 (začasni podatki)";1553;753;800
"2242";"Goriška";"18";"2009";1468;629;839
"2243";"Goriška";"18";"2010";1435;655;780
"2244";"Goriška";"18";"2011";1427;616;811
"2245";"Goriška";"18";"2012";1442;671;771
"2246";"Goriška";"18";"2013";1339;672;667
"2247";"Goriška";"18";"2014";1376;668;708
"2248";"Goriška";"18";"2015";1350;699;651
"2249";"Goriška";"18";"2016";1373;729;644
"2250";"Goriška";"18";"2017 (začasni podatki)";1349;708;641
"2251";"Goriška";"19";"2009";1487;803;684
"2252";"Goriška";"19";"2010";1382;772;610
"2253";"Goriška";"19";"2011";1311;741;570
"2254";"Goriška";"19";"2012";1316;766;550
"2255";"Goriška";"19";"2013";1246;741;505
"2256";"Goriška";"19";"2014";1279;779;500
"2257";"Goriška";"19";"2015";1175;714;461
"2258";"Goriška";"19";"2016";1271;782;489
"2259";"Goriška";"19";"2017 (začasni podatki)";1257;786;471
"2260";"Goriška";"20";"2009";1350;949;401
"2261";"Goriška";"20";"2010";1231;849;382
"2262";"Goriška";"20";"2011";1181;826;355
"2263";"Goriška";"20";"2012";1065;729;336
"2264";"Goriška";"20";"2013";957;649;308
"2265";"Goriška";"20";"2014";942;645;297
"2266";"Goriška";"20";"2015";891;618;273
"2267";"Goriška";"20";"2016";945;652;293
"2268";"Goriška";"20";"2017 (začasni podatki)";936;633;303
"2269";"Obalno-kraška";"Razred neto - SKUPAJ";"2009";31889;18173;13716
"2270";"Obalno-kraška";"Razred neto - SKUPAJ";"2010";31042;17651;13391
"2271";"Obalno-kraška";"Razred neto - SKUPAJ";"2011";30066;16453;13613
"2272";"Obalno-kraška";"Razred neto - SKUPAJ";"2012";28085;15227;12858
"2273";"Obalno-kraška";"Razred neto - SKUPAJ";"2013";27062;14481;12581
"2274";"Obalno-kraška";"Razred neto - SKUPAJ";"2014";27459;14824;12635
"2275";"Obalno-kraška";"Razred neto - SKUPAJ";"2015";27257;14861;12396
"2276";"Obalno-kraška";"Razred neto - SKUPAJ";"2016";27545;14944;12601
"2277";"Obalno-kraška";"Razred neto - SKUPAJ";"2017 (začasni podatki)";29086;15935;13151
"2278";"Obalno-kraška";"01";"2009";1685;1195;490
"2279";"Obalno-kraška";"01";"2010";1500;980;520
"2280";"Obalno-kraška";"01";"2011";1441;817;624
"2281";"Obalno-kraška";"01";"2012";1498;797;701
"2282";"Obalno-kraška";"01";"2013";1423;723;700
"2283";"Obalno-kraška";"01";"2014";1451;738;713
"2284";"Obalno-kraška";"01";"2015";1496;767;729
"2285";"Obalno-kraška";"01";"2016";1377;754;623
"2286";"Obalno-kraška";"01";"2017 (začasni podatki)";1446;772;674
"2287";"Obalno-kraška";"02";"2009";1526;903;623
"2288";"Obalno-kraška";"02";"2010";1655;925;730
"2289";"Obalno-kraška";"02";"2011";1641;831;810
"2290";"Obalno-kraška";"02";"2012";1349;652;697
"2291";"Obalno-kraška";"02";"2013";1409;696;713
"2292";"Obalno-kraška";"02";"2014";1325;634;691
"2293";"Obalno-kraška";"02";"2015";1497;780;717
"2294";"Obalno-kraška";"02";"2016";1481;732;749
"2295";"Obalno-kraška";"02";"2017 (začasni podatki)";1582;807;775
"2296";"Obalno-kraška";"03";"2009";1445;646;799
"2297";"Obalno-kraška";"03";"2010";1504;781;723
"2298";"Obalno-kraška";"03";"2011";1470;800;670
"2299";"Obalno-kraška";"03";"2012";1412;769;643
"2300";"Obalno-kraška";"03";"2013";1336;784;552
"2301";"Obalno-kraška";"03";"2014";1468;818;650
"2302";"Obalno-kraška";"03";"2015";1387;764;623
"2303";"Obalno-kraška";"03";"2016";1481;781;700
"2304";"Obalno-kraška";"03";"2017 (začasni podatki)";1511;804;707
"2305";"Obalno-kraška";"04";"2009";1352;613;739
"2306";"Obalno-kraška";"04";"2010";1491;737;754
"2307";"Obalno-kraška";"04";"2011";1466;742;724
"2308";"Obalno-kraška";"04";"2012";1268;635;633
"2309";"Obalno-kraška";"04";"2013";1342;660;682
"2310";"Obalno-kraška";"04";"2014";1272;658;614
"2311";"Obalno-kraška";"04";"2015";1392;733;659
"2312";"Obalno-kraška";"04";"2016";1376;716;660
"2313";"Obalno-kraška";"04";"2017 (začasni podatki)";1542;792;750
"2314";"Obalno-kraška";"05";"2009";1278;658;620
"2315";"Obalno-kraška";"05";"2010";1430;735;695
"2316";"Obalno-kraška";"05";"2011";1371;727;644
"2317";"Obalno-kraška";"05";"2012";1315;684;631
"2318";"Obalno-kraška";"05";"2013";1243;653;590
"2319";"Obalno-kraška";"05";"2014";1292;701;591
"2320";"Obalno-kraška";"05";"2015";1237;725;512
"2321";"Obalno-kraška";"05";"2016";1239;671;568
"2322";"Obalno-kraška";"05";"2017 (začasni podatki)";1457;786;671
"2323";"Obalno-kraška";"06";"2009";1405;789;616
"2324";"Obalno-kraška";"06";"2010";1493;874;619
"2325";"Obalno-kraška";"06";"2011";1460;805;655
"2326";"Obalno-kraška";"06";"2012";1331;751;580
"2327";"Obalno-kraška";"06";"2013";1265;754;511
"2328";"Obalno-kraška";"06";"2014";1312;778;534
"2329";"Obalno-kraška";"06";"2015";1320;737;583
"2330";"Obalno-kraška";"06";"2016";1296;712;584
"2331";"Obalno-kraška";"06";"2017 (začasni podatki)";1545;859;686
"2332";"Obalno-kraška";"07";"2009";1417;843;574
"2333";"Obalno-kraška";"07";"2010";1428;874;554
"2334";"Obalno-kraška";"07";"2011";1457;864;593
"2335";"Obalno-kraška";"07";"2012";1475;878;597
"2336";"Obalno-kraška";"07";"2013";1409;818;591
"2337";"Obalno-kraška";"07";"2014";1427;815;612
"2338";"Obalno-kraška";"07";"2015";1384;833;551
"2339";"Obalno-kraška";"07";"2016";1414;843;571
"2340";"Obalno-kraška";"07";"2017 (začasni podatki)";1473;913;560
"2341";"Obalno-kraška";"08";"2009";1453;898;555
"2342";"Obalno-kraška";"08";"2010";1489;911;578
"2343";"Obalno-kraška";"08";"2011";1549;920;629
"2344";"Obalno-kraška";"08";"2012";1449;877;572
"2345";"Obalno-kraška";"08";"2013";1431;883;548
"2346";"Obalno-kraška";"08";"2014";1393;846;547
"2347";"Obalno-kraška";"08";"2015";1428;870;558
"2348";"Obalno-kraška";"08";"2016";1385;833;552
"2349";"Obalno-kraška";"08";"2017 (začasni podatki)";1494;926;568
"2350";"Obalno-kraška";"09";"2009";1580;980;600
"2351";"Obalno-kraška";"09";"2010";1485;894;591
"2352";"Obalno-kraška";"09";"2011";1574;952;622
"2353";"Obalno-kraška";"09";"2012";1466;870;596
"2354";"Obalno-kraška";"09";"2013";1481;903;578
"2355";"Obalno-kraška";"09";"2014";1442;854;588
"2356";"Obalno-kraška";"09";"2015";1370;800;570
"2357";"Obalno-kraška";"09";"2016";1369;821;548
"2358";"Obalno-kraška";"09";"2017 (začasni podatki)";1396;840;556
"2359";"Obalno-kraška";"10";"2009";1656;976;680
"2360";"Obalno-kraška";"10";"2010";1580;932;648
"2361";"Obalno-kraška";"10";"2011";1518;862;656
"2362";"Obalno-kraška";"10";"2012";1429;819;610
"2363";"Obalno-kraška";"10";"2013";1295;731;564
"2364";"Obalno-kraška";"10";"2014";1315;762;553
"2365";"Obalno-kraška";"10";"2015";1311;761;550
"2366";"Obalno-kraška";"10";"2016";1340;720;620
"2367";"Obalno-kraška";"10";"2017 (začasni podatki)";1458;805;653
"2368";"Obalno-kraška";"11";"2009";1623;973;650
"2369";"Obalno-kraška";"11";"2010";1544;904;640
"2370";"Obalno-kraška";"11";"2011";1483;807;676
"2371";"Obalno-kraška";"11";"2012";1402;768;634
"2372";"Obalno-kraška";"11";"2013";1314;708;606
"2373";"Obalno-kraška";"11";"2014";1340;708;632
"2374";"Obalno-kraška";"11";"2015";1374;713;661
"2375";"Obalno-kraška";"11";"2016";1370;729;641
"2376";"Obalno-kraška";"11";"2017 (začasni podatki)";1436;780;656
"2377";"Obalno-kraška";"12";"2009";1758;983;775
"2378";"Obalno-kraška";"12";"2010";1602;894;708
"2379";"Obalno-kraška";"12";"2011";1645;876;769
"2380";"Obalno-kraška";"12";"2012";1444;727;717
"2381";"Obalno-kraška";"12";"2013";1398;692;706
"2382";"Obalno-kraška";"12";"2014";1364;679;685
"2383";"Obalno-kraška";"12";"2015";1344;684;660
"2384";"Obalno-kraška";"12";"2016";1396;718;678
"2385";"Obalno-kraška";"12";"2017 (začasni podatki)";1358;699;659
"2386";"Obalno-kraška";"13";"2009";1808;956;852
"2387";"Obalno-kraška";"13";"2010";1689;925;764
"2388";"Obalno-kraška";"13";"2011";1557;812;745
"2389";"Obalno-kraška";"13";"2012";1422;701;721
"2390";"Obalno-kraška";"13";"2013";1370;646;724
"2391";"Obalno-kraška";"13";"2014";1381;662;719
"2392";"Obalno-kraška";"13";"2015";1318;670;648
"2393";"Obalno-kraška";"13";"2016";1307;677;630
"2394";"Obalno-kraška";"13";"2017 (začasni podatki)";1406;723;683
"2395";"Obalno-kraška";"14";"2009";1815;1035;780
"2396";"Obalno-kraška";"14";"2010";1704;938;766
"2397";"Obalno-kraška";"14";"2011";1488;772;716
"2398";"Obalno-kraška";"14";"2012";1385;698;687
"2399";"Obalno-kraška";"14";"2013";1336;646;690
"2400";"Obalno-kraška";"14";"2014";1368;717;651
"2401";"Obalno-kraška";"14";"2015";1329;672;657
"2402";"Obalno-kraška";"14";"2016";1341;694;647
"2403";"Obalno-kraška";"14";"2017 (začasni podatki)";1400;707;693
"2404";"Obalno-kraška";"15";"2009";1828;1016;812
"2405";"Obalno-kraška";"15";"2010";1662;945;717
"2406";"Obalno-kraška";"15";"2011";1553;832;721
"2407";"Obalno-kraška";"15";"2012";1481;831;650
"2408";"Obalno-kraška";"15";"2013";1299;646;653
"2409";"Obalno-kraška";"15";"2014";1448;771;677
"2410";"Obalno-kraška";"15";"2015";1296;683;613
"2411";"Obalno-kraška";"15";"2016";1399;714;685
"2412";"Obalno-kraška";"15";"2017 (začasni podatki)";1401;687;714
"2413";"Obalno-kraška";"16";"2009";1786;1069;717
"2414";"Obalno-kraška";"16";"2010";1690;979;711
"2415";"Obalno-kraška";"16";"2011";1521;792;729
"2416";"Obalno-kraška";"16";"2012";1477;772;705
"2417";"Obalno-kraška";"16";"2013";1371;660;711
"2418";"Obalno-kraška";"16";"2014";1401;708;693
"2419";"Obalno-kraška";"16";"2015";1316;631;685
"2420";"Obalno-kraška";"16";"2016";1356;650;706
"2421";"Obalno-kraška";"16";"2017 (začasni podatki)";1413;694;719
"2422";"Obalno-kraška";"17";"2009";1763;936;827
"2423";"Obalno-kraška";"17";"2010";1651;860;791
"2424";"Obalno-kraška";"17";"2011";1572;771;801
"2425";"Obalno-kraška";"17";"2012";1489;725;764
"2426";"Obalno-kraška";"17";"2013";1394;620;774
"2427";"Obalno-kraška";"17";"2014";1437;645;792
"2428";"Obalno-kraška";"17";"2015";1407;637;770
"2429";"Obalno-kraška";"17";"2016";1419;672;747
"2430";"Obalno-kraška";"17";"2017 (začasni podatki)";1432;711;721
"2431";"Obalno-kraška";"18";"2009";1755;905;850
"2432";"Obalno-kraška";"18";"2010";1683;885;798
"2433";"Obalno-kraška";"18";"2011";1589;826;763
"2434";"Obalno-kraška";"18";"2012";1519;784;735
"2435";"Obalno-kraška";"18";"2013";1393;706;687
"2436";"Obalno-kraška";"18";"2014";1426;729;697
"2437";"Obalno-kraška";"18";"2015";1346;647;699
"2438";"Obalno-kraška";"18";"2016";1431;718;713
"2439";"Obalno-kraška";"18";"2017 (začasni podatki)";1508;813;695
"2440";"Obalno-kraška";"19";"2009";1605;914;691
"2441";"Obalno-kraška";"19";"2010";1489;860;629
"2442";"Obalno-kraška";"19";"2011";1469;845;624
"2443";"Obalno-kraška";"19";"2012";1323;761;562
"2444";"Obalno-kraška";"19";"2013";1389;801;588
"2445";"Obalno-kraška";"19";"2014";1408;834;574
"2446";"Obalno-kraška";"19";"2015";1389;872;517
"2447";"Obalno-kraška";"19";"2016";1436;890;546
"2448";"Obalno-kraška";"19";"2017 (začasni podatki)";1475;915;560
"2449";"Obalno-kraška";"20";"2009";1351;885;466
"2450";"Obalno-kraška";"20";"2010";1273;818;455
"2451";"Obalno-kraška";"20";"2011";1242;800;442
"2452";"Obalno-kraška";"20";"2012";1151;728;423
"2453";"Obalno-kraška";"20";"2013";1164;751;413
"2454";"Obalno-kraška";"20";"2014";1189;767;422
"2455";"Obalno-kraška";"20";"2015";1316;882;434
"2456";"Obalno-kraška";"20";"2016";1332;899;433
"2457";"Obalno-kraška";"20";"2017 (začasni podatki)";1353;902;451
